player,pos,age,g,gs,mp,fg,fga,fg_percent,x3p,x3pa,x3p_percent,x2p,x2pa,x2p_percent,e_fg_percent,ft,fta,ft_percent,orb,drb,trb,ast,stl,blk,tov,pf,pts
Precious Achiuwa,PF-C,24,67,18,1522,229,449,0.51,25,93,0.269,204,356,0.573,0.538,69,112,0.616,184,277,461,94,44,66,78,130,552
Precious Achiuwa,C,24,25,0,437,78,170,0.459,13,47,0.277,65,123,0.528,0.497,24,42,0.571,50,86,136,44,16,12,29,40,193
Precious Achiuwa,PF,24,42,18,1085,151,279,0.541,12,46,0.261,139,233,0.597,0.563,45,70,0.643,134,191,325,50,28,54,49,90,359
Bam Adebayo,C,26,63,63,2162,480,922,0.521,10,30,0.333,470,892,0.527,0.526,276,367,0.752,142,529,671,253,73,61,148,144,1246
Ochai Agbaji,SG,23,72,23,1457,164,396,0.414,61,200,0.305,103,196,0.526,0.491,28,42,0.667,66,128,194,73,42,38,55,102,417
Ochai Agbaji,SG,23,51,10,1003,106,249,0.426,47,142,0.331,59,107,0.551,0.52,15,20,0.75,35,91,126,47,27,29,34,66,274
Ochai Agbaji,SG,23,21,13,454,58,147,0.395,14,58,0.241,44,89,0.494,0.442,13,22,0.591,31,37,68,26,15,9,21,36,143
Santi Aldama,PF,23,60,34,1595,246,565,0.435,106,302,0.351,140,263,0.532,0.529,54,87,0.621,72,277,349,136,43,51,69,87,652
Nickeil Alexander-Walker,SG,25,74,19,1742,203,472,0.43,113,296,0.382,90,176,0.511,0.55,44,56,0.786,33,118,151,185,57,39,69,130,563
Grayson Allen,SG,28,68,68,2284,307,608,0.505,187,398,0.47,120,210,0.571,0.659,114,129,0.884,43,218,261,213,60,42,87,144,915
Jarrett Allen,C,25,70,70,2209,463,735,0.63,0,5,0,463,730,0.634,0.63,216,291,0.742,219,523,742,187,48,77,113,138,1142
Jose Alvarado,PG,25,51,0,908,126,309,0.408,66,178,0.371,60,131,0.458,0.515,34,50,0.68,22,93,115,107,55,15,38,79,352
Kyle Anderson,PF,30,71,10,1624,182,388,0.469,9,40,0.225,173,348,0.497,0.481,94,131,0.718,58,198,256,302,62,40,83,110,467
Giannis Antetokounmpo,PF,29,69,69,2432,795,1294,0.614,34,119,0.286,761,1175,0.648,0.628,499,757,0.659,186,610,796,443,84,70,237,201,2123
Thanasis Antetokounmpo,PF,31,29,0,136,13,26,0.5,0,1,0,13,25,0.52,0.5,0,2,0,6,6,12,14,5,4,12,23,26
Cole Anthony,PG,23,73,0,1675,306,701,0.437,87,255,0.341,219,446,0.491,0.499,171,209,0.818,62,232,294,218,58,35,114,167,870
OG Anunoby,SF,26,44,44,1498,250,508,0.492,89,240,0.371,161,268,0.601,0.58,66,86,0.767,42,148,190,99,57,31,70,102,655
OG Anunoby,SF,26,27,27,900,157,321,0.489,61,163,0.374,96,158,0.608,0.584,33,46,0.717,24,82,106,72,28,13,43,62,408
OG Anunoby,SF,26,17,17,598,93,187,0.497,28,77,0.364,65,110,0.591,0.572,33,40,0.825,18,66,84,27,29,18,27,40,247
Deni Avdija,SF,23,68,68,2013,360,712,0.506,80,206,0.388,280,506,0.553,0.562,170,231,0.736,80,407,487,259,55,28,142,168,970
Deandre Ayton,C,25,48,48,1543,351,605,0.58,1,4,0.25,350,601,0.582,0.581,56,69,0.812,152,376,528,77,47,38,87,100,759
Marvin Bagley III,C,24,49,24,1044,237,403,0.588,9,22,0.409,228,381,0.598,0.599,96,126,0.762,130,179,309,55,19,33,58,81,579
Marvin Bagley III,C,24,26,10,478,107,181,0.591,1,6,0.167,106,175,0.606,0.594,50,61,0.82,46,72,118,27,5,14,29,40,265
Marvin Bagley III,C,24,23,14,566,130,222,0.586,8,16,0.5,122,206,0.592,0.604,46,65,0.708,84,107,191,28,14,19,29,41,314
Amari Bailey,PG,19,8,0,31,3,12,0.25,0,5,0,3,7,0.429,0.25,1,2,0.5,2,0,2,2,1,0,1,0,7
Patrick Baldwin Jr.,SF,21,32,4,331,33,105,0.314,18,65,0.277,15,40,0.375,0.4,13,19,0.684,13,70,83,20,10,11,14,37,97
LaMelo Ball,PG,22,22,22,711,183,423,0.433,70,197,0.355,113,226,0.5,0.515,90,104,0.865,29,84,113,176,40,4,83,79,526
Mo Bamba,C,25,53,16,703,94,188,0.5,24,60,0.4,70,128,0.547,0.564,32,48,0.667,74,150,224,40,22,55,39,95,244
Paolo Banchero,PF,21,72,72,2504,577,1246,0.463,108,306,0.353,469,940,0.499,0.506,350,491,0.713,74,417,491,384,68,43,226,140,1612
Desmond Bane,SG,25,42,42,1443,360,776,0.464,137,360,0.381,223,416,0.536,0.552,140,161,0.87,36,149,185,230,43,22,112,120,997
Dalano Banton,PG,24,47,8,799,151,364,0.415,45,139,0.324,106,225,0.471,0.477,66,85,0.776,38,106,144,89,23,15,59,56,413
Dalano Banton,PG,24,24,1,171,19,51,0.373,2,16,0.125,17,35,0.486,0.392,16,20,0.8,12,23,35,19,5,3,10,20,56
Dalano Banton,PG,24,23,7,628,132,313,0.422,43,123,0.35,89,190,0.468,0.49,50,65,0.769,26,83,109,70,18,12,49,36,357
Dominick Barlow,PF,20,33,1,420,56,113,0.496,3,9,0.333,53,104,0.51,0.509,29,42,0.69,45,68,113,36,12,14,9,47,144
Harrison Barnes,PF,31,74,74,2171,323,669,0.483,140,351,0.399,183,318,0.575,0.587,135,168,0.804,59,160,219,87,47,11,53,92,921
Scottie Barnes,SG,22,60,60,2094,447,942,0.475,101,296,0.341,346,646,0.536,0.528,196,251,0.781,141,353,494,363,75,88,165,118,1191
RJ Barrett,SG,23,53,53,1675,385,788,0.489,86,233,0.369,299,555,0.539,0.543,180,254,0.709,46,233,279,171,28,20,107,114,1036
RJ Barrett,SG,23,26,26,766,164,388,0.423,43,130,0.331,121,258,0.469,0.478,103,124,0.831,19,92,111,63,12,9,47,45,474
RJ Barrett,SG,23,27,27,909,221,400,0.553,43,103,0.417,178,297,0.599,0.606,77,130,0.592,27,141,168,108,16,11,60,69,562
Charles Bassey,C,23,19,0,205,29,40,0.725,0,1,0,29,39,0.744,0.725,5,6,0.833,23,53,76,21,8,17,15,31,63
Emoni Bates,SF,20,13,0,102,12,37,0.324,9,28,0.321,3,9,0.333,0.446,1,4,0.25,1,10,11,7,1,2,2,5,34
Keita Bates-Diop,SF,28,53,8,665,72,166,0.434,21,69,0.304,51,97,0.526,0.497,32,42,0.762,31,79,110,38,25,22,15,35,197
Keita Bates-Diop,SF,28,39,8,597,64,150,0.427,20,64,0.313,44,86,0.512,0.493,26,36,0.722,30,71,101,34,22,20,13,33,174
Keita Bates-Diop,SF,28,14,0,68,8,16,0.5,1,5,0.2,7,11,0.636,0.531,6,6,1,1,8,9,4,3,2,2,2,23
Nicolas Batum,PF,35,53,34,1321,104,221,0.471,65,158,0.411,39,63,0.619,0.618,15,21,0.714,66,154,220,110,40,35,34,99,288
Nicolas Batum,PF,35,50,34,1267,101,213,0.474,63,151,0.417,38,62,0.613,0.622,15,21,0.714,66,147,213,105,37,31,33,94,280
Bradley Beal,SG,30,45,45,1485,312,626,0.498,76,199,0.382,236,427,0.553,0.559,96,121,0.793,40,144,184,229,43,17,113,106,796
Malik Beasley,SG,27,71,71,2122,297,654,0.454,210,492,0.427,87,162,0.537,0.615,24,34,0.706,40,229,269,97,55,9,50,145,828
MarJon Beauchamp,SF,23,46,1,593,75,157,0.478,28,72,0.389,47,85,0.553,0.567,19,28,0.679,22,74,96,30,12,6,27,53,197
Jules Bernard,SG,24,15,0,111,21,50,0.42,9,25,0.36,12,25,0.48,0.51,4,8,0.5,7,9,16,13,2,1,4,11,55
D─vis Bert─ns,PF,31,36,0,516,68,179,0.38,60,155,0.387,8,24,0.333,0.547,27,30,0.9,7,41,48,29,18,8,11,40,223
D─vis Bert─ns,PF,31,15,0,91,10,26,0.385,10,24,0.417,0,2,0,0.577,14,15,0.933,2,8,10,9,3,3,1,10,44
D─vis Bert─ns,PF,31,21,0,425,58,153,0.379,50,131,0.382,8,22,0.364,0.542,13,15,0.867,5,33,38,20,15,5,10,30,179
Patrick Beverley,PG,35,68,8,1334,142,348,0.408,54,167,0.323,88,181,0.486,0.486,70,86,0.814,43,165,208,191,39,30,62,122,408
Patrick Beverley,PG,35,47,5,919,104,241,0.432,35,109,0.321,69,132,0.523,0.504,51,63,0.81,30,115,145,144,24,18,49,83,294
Patrick Beverley,PG,35,21,3,415,38,107,0.355,19,58,0.328,19,49,0.388,0.444,19,23,0.826,13,50,63,47,15,12,13,39,114
Saddiq Bey,SF,24,63,51,2062,290,697,0.416,113,358,0.316,177,339,0.522,0.497,170,203,0.837,167,244,411,92,51,11,54,88,863
Goga Bitadze,C,24,57,33,933,124,203,0.611,2,13,0.154,122,190,0.642,0.616,54,82,0.659,108,170,278,78,30,71,42,104,304
Onuralp Bitim,SG,24,18,0,226,28,66,0.424,11,35,0.314,17,31,0.548,0.508,3,4,0.75,6,24,30,13,3,2,7,20,70
Anthony Black,PG,20,65,33,1134,111,242,0.459,35,91,0.385,76,151,0.503,0.531,49,80,0.613,33,105,138,90,35,21,53,108,306
Leaky Black,SF,24,22,3,218,17,39,0.436,7,15,0.467,10,24,0.417,0.526,9,14,0.643,8,30,38,18,5,6,5,15,50
Buddy Boeheim,SF,24,5,0,49,7,20,0.35,6,17,0.353,1,3,0.333,0.5,5,5,1,1,7,8,3,0,1,0,3,25
Bogdan Bogdanovi?,SG,31,71,25,2144,428,1000,0.428,219,582,0.376,209,418,0.5,0.538,128,141,0.908,50,199,249,220,88,20,96,162,1203
Bojan Bogdanovi?,PF-SF,34,49,27,1339,275,612,0.449,120,304,0.395,155,308,0.503,0.547,107,137,0.781,19,118,137,92,28,5,94,90,777
Bojan Bogdanovi?,PF,34,28,27,921,199,425,0.468,86,207,0.415,113,218,0.518,0.569,81,104,0.779,13,81,94,71,23,4,63,57,565
Bojan Bogdanovi?,SF,34,21,0,418,76,187,0.406,34,97,0.351,42,90,0.467,0.497,26,33,0.788,6,37,43,21,5,1,31,33,212
Bol Bol,PF,24,36,0,407,83,134,0.619,19,45,0.422,64,89,0.719,0.69,13,17,0.765,30,90,120,16,6,22,15,39,198
Devin Booker,PG,27,60,60,2142,571,1161,0.492,128,354,0.362,443,807,0.549,0.547,348,395,0.881,49,237,286,413,52,26,151,184,1618
Brandon Boston Jr.,SF,22,26,0,221,41,97,0.423,9,30,0.3,32,67,0.478,0.469,15,22,0.682,11,19,30,7,4,7,11,27,106
Chris Boucher,PF,31,50,0,705,110,217,0.507,31,94,0.33,79,123,0.642,0.578,71,92,0.772,62,145,207,23,14,24,28,68,322
James Bouknight,SG,23,14,0,81,18,41,0.439,13,30,0.433,5,11,0.455,0.598,1,2,0.5,1,8,9,6,1,1,2,3,50
Malaki Branham,PG,20,70,24,1431,241,563,0.428,78,233,0.335,163,330,0.494,0.497,53,59,0.898,27,108,135,149,25,7,82,84,613
Christian Braun,SG,22,75,2,1466,198,432,0.458,53,141,0.376,145,291,0.498,0.52,85,123,0.691,69,204,273,107,36,32,51,127,534
Mikal Bridges,SF,27,75,75,2661,535,1223,0.437,203,551,0.368,332,672,0.494,0.52,252,310,0.813,64,289,353,277,77,28,157,110,1525
Miles Bridges,SF,25,63,61,2376,517,1120,0.462,147,418,0.352,370,702,0.527,0.527,160,197,0.812,67,401,468,208,63,30,128,111,1341
Oshae Brissett,SF,25,48,1,561,59,130,0.454,15,51,0.294,44,79,0.557,0.512,43,67,0.642,51,86,137,38,16,5,15,49,176
Malcolm Brogdon,PG,31,39,25,1121,218,496,0.44,82,199,0.412,136,297,0.458,0.522,95,116,0.819,28,120,148,214,27,8,60,58,613
Armoni Brooks,PG,25,10,0,104,15,46,0.326,11,32,0.344,4,14,0.286,0.446,1,2,0.5,7,11,18,5,1,1,3,3,42
Dillon Brooks,SF,28,65,65,2004,297,692,0.429,118,333,0.354,179,359,0.499,0.514,111,132,0.841,47,177,224,109,56,9,82,211,823
Bruce Brown,SG-PG,27,62,43,1748,257,546,0.471,51,156,0.327,206,390,0.528,0.517,111,132,0.841,52,217,269,181,56,17,80,137,676
Bruce Brown,SG,27,33,33,981,149,314,0.475,33,101,0.327,116,213,0.545,0.527,67,82,0.817,25,129,154,100,35,8,41,81,398
Bruce Brown,PG,27,29,10,767,108,232,0.466,18,55,0.327,90,177,0.508,0.504,44,50,0.88,27,88,115,81,21,9,39,56,278
Greg Brown III,PF,22,6,0,40,5,11,0.455,1,3,0.333,4,8,0.5,0.5,4,9,0.444,3,6,9,4,0,4,4,5,15
Jaylen Brown,SF,27,66,66,2216,595,1185,0.502,138,385,0.358,457,800,0.571,0.56,204,291,0.701,78,286,364,239,77,32,151,173,1532
Kendall Brown,SG,20,12,0,43,6,10,0.6,0,1,0,6,9,0.667,0.6,5,8,0.625,3,1,4,4,0,0,1,5,17
Kobe Brown,PF,24,38,0,299,26,65,0.4,12,39,0.308,14,26,0.538,0.492,1,2,0.5,10,37,47,17,6,3,7,42,65
Troy Brown Jr.,SF,24,51,7,632,71,181,0.392,41,120,0.342,30,61,0.492,0.506,28,33,0.848,19,92,111,49,12,2,26,35,211
Troy Brown Jr.,SF,24,37,3,410,52,118,0.441,31,84,0.369,21,34,0.618,0.572,19,22,0.864,14,58,72,35,8,2,18,26,154
Troy Brown Jr.,SF,24,14,4,222,19,63,0.302,10,36,0.278,9,27,0.333,0.381,9,11,0.818,5,34,39,14,4,0,8,9,57
Jalen Brunson,PG,27,69,69,2421,692,1448,0.478,188,470,0.4,504,978,0.515,0.543,353,420,0.84,39,209,248,449,63,13,165,130,1925
Thomas Bryant,C,26,37,4,418,78,139,0.561,4,21,0.19,74,118,0.627,0.576,39,45,0.867,37,94,131,22,10,15,19,45,199
Kobe Bufkin,SG,20,9,0,89,13,37,0.351,5,17,0.294,8,20,0.4,0.419,2,4,0.5,2,12,14,15,3,1,5,6,33
Reggie Bullock,SF,32,36,0,346,30,74,0.405,24,60,0.4,6,14,0.429,0.568,1,1,1,6,59,65,13,9,3,8,20,85
Alec Burks,SG,32,62,1,1181,209,561,0.373,123,326,0.377,86,235,0.366,0.482,143,165,0.867,24,121,145,84,25,12,46,74,684
Alec Burks,SG,32,43,0,901,160,406,0.394,99,247,0.401,61,159,0.384,0.516,121,134,0.903,16,94,110,68,21,11,32,64,540
Alec Burks,SG,32,19,1,280,49,155,0.316,24,79,0.304,25,76,0.329,0.394,22,31,0.71,8,27,35,16,4,1,14,10,144
Jared Butler,SG,23,33,0,408,67,139,0.482,16,56,0.286,51,83,0.614,0.54,21,24,0.875,6,32,38,92,19,5,40,40,171
Jimmy Butler,PF,34,52,52,1762,348,696,0.5,50,121,0.413,298,575,0.518,0.536,348,407,0.855,95,184,279,253,72,17,86,61,1094
Jamal Cain,PF,24,22,1,253,34,79,0.43,11,31,0.355,23,48,0.479,0.5,18,23,0.783,15,21,36,10,10,5,8,21,97
Kentavious Caldwell-Pope,SG,30,69,69,2195,240,528,0.455,111,274,0.405,129,254,0.508,0.56,100,109,0.917,29,138,167,168,93,37,69,135,691
Toumani Camara,PF,23,70,49,1739,197,438,0.45,58,172,0.337,139,266,0.523,0.516,75,99,0.758,139,204,343,87,66,33,84,174,527
Clint Capela,C,29,66,66,1684,318,561,0.567,0,1,0,318,560,0.568,0.567,115,179,0.642,310,386,696,79,38,100,64,154,751
Jevon Carter,PG,28,67,0,917,126,327,0.385,70,208,0.337,56,119,0.471,0.492,4,7,0.571,8,46,54,79,33,14,34,67,326
Wendell Carter Jr.,C,24,47,41,1217,191,365,0.523,53,141,0.376,138,224,0.616,0.596,86,123,0.699,95,236,331,81,28,25,60,100,521
D.J. Carton,SG,23,4,0,36,3,8,0.375,1,4,0.25,2,4,0.5,0.438,4,5,0.8,2,2,4,3,1,0,1,3,11
Alex Caruso,SG,29,66,52,1864,236,501,0.471,126,309,0.408,110,192,0.573,0.597,70,92,0.761,58,195,253,216,108,66,93,170,668
Julian Champagnie,SF,22,67,52,1237,134,338,0.396,88,239,0.368,46,99,0.465,0.527,58,71,0.817,38,137,175,85,41,36,47,70,414
Justin Champagnie,SF,22,10,1,151,20,50,0.4,10,32,0.313,10,18,0.556,0.5,10,12,0.833,11,18,29,12,6,6,9,12,60
Max Christie,SG,20,61,7,909,97,225,0.431,40,111,0.36,57,114,0.5,0.52,34,44,0.773,13,120,133,55,18,16,35,56,268
Sidy Cissoko,SF,19,6,0,32,1,6,0.167,0,4,0,1,2,0.5,0.167,4,4,1,0,6,6,0,3,0,1,2,6
Brandon Clarke,PF,27,2,0,41,9,16,0.563,0,2,0,9,14,0.643,0.563,1,3,0.333,3,6,9,4,2,1,0,3,19
Jordan Clarkson,SG,31,55,19,1682,337,816,0.413,91,309,0.294,246,507,0.485,0.469,177,201,0.881,49,139,188,277,35,6,146,81,942
Nic Claxton,C,24,65,65,1939,341,543,0.628,1,5,0.2,340,538,0.632,0.629,103,180,0.572,180,462,642,134,46,131,80,163,786
Noah Clowney,PF,19,16,0,164,18,40,0.45,4,16,0.25,14,24,0.583,0.5,8,12,0.667,11,25,36,9,4,3,6,12,48
Amir Coffey,SF,26,62,11,1216,136,270,0.504,58,140,0.414,78,130,0.6,0.611,49,56,0.875,23,94,117,67,33,11,30,86,379
John Collins,PF,26,68,66,1901,397,746,0.532,86,232,0.371,311,514,0.605,0.59,147,185,0.795,157,418,575,77,40,61,98,191,1027
Zach Collins,C,26,62,27,1384,261,545,0.479,51,164,0.311,210,381,0.551,0.526,109,146,0.747,105,217,322,177,31,45,120,192,682
Mike Conley,PG,36,69,69,1997,265,582,0.455,158,364,0.434,107,218,0.491,0.591,91,101,0.901,32,164,196,417,78,15,81,117,779
Pat Connaughton,SF,31,68,2,1473,135,295,0.458,75,203,0.369,60,92,0.652,0.585,36,49,0.735,43,170,213,137,34,16,43,84,381
Bilal Coulibaly,SF,19,63,15,1715,188,432,0.435,64,185,0.346,124,247,0.502,0.509,92,131,0.702,56,200,256,110,57,48,87,137,532
Ricky Council IV,SG,22,27,0,236,47,98,0.48,9,27,0.333,38,71,0.535,0.526,50,68,0.735,13,28,41,11,2,1,4,13,153
Robert Covington,SF-PF,33,29,6,488,43,98,0.439,19,56,0.339,24,42,0.571,0.536,22,26,0.846,31,66,97,24,39,18,11,56,127
Robert Covington,PF,33,3,3,69,3,9,0.333,2,8,0.25,1,1,1,0.444,1,2,0.5,2,6,8,7,6,2,0,7,9
Robert Covington,SF,33,26,3,419,40,89,0.449,17,48,0.354,23,41,0.561,0.545,21,24,0.875,29,60,89,17,33,16,11,49,118
Torrey Craig,SF,33,46,13,934,100,230,0.435,56,143,0.392,44,87,0.506,0.557,25,33,0.758,63,127,190,52,26,19,29,99,281
Jae Crowder,PF,33,43,23,999,101,228,0.443,51,140,0.364,50,88,0.568,0.555,21,29,0.724,23,116,139,59,35,7,19,70,274
Cade Cunningham,PG,22,61,61,2040,511,1145,0.446,116,331,0.35,395,814,0.485,0.497,231,266,0.868,32,232,264,456,54,21,208,152,1369
Seth Curry,SG,33,44,4,616,80,204,0.392,38,108,0.352,42,96,0.438,0.485,28,31,0.903,18,50,68,44,22,6,21,39,226
Seth Curry,SG,33,36,3,457,54,145,0.372,29,80,0.363,25,65,0.385,0.472,17,19,0.895,15,37,52,30,17,3,16,32,154
Seth Curry,SG,33,8,1,159,26,59,0.441,9,28,0.321,17,31,0.548,0.517,11,12,0.917,3,13,16,14,5,3,5,7,72
Stephen Curry,PG,35,68,68,2223,600,1336,0.449,329,816,0.403,271,520,0.521,0.572,279,302,0.924,36,257,293,340,49,22,191,108,1808
Dyson Daniels,PG,20,53,15,1149,113,259,0.436,32,112,0.286,81,147,0.551,0.498,32,50,0.64,54,140,194,138,74,21,53,85,290
Anthony Davis,C,30,70,70,2511,660,1190,0.555,27,94,0.287,633,1096,0.578,0.566,381,467,0.816,219,670,889,249,81,167,144,163,1728
Johnny Davis,SG,21,44,2,498,48,132,0.364,8,32,0.25,40,100,0.4,0.394,9,15,0.6,18,45,63,24,14,9,8,39,113
Dexter Dennis,SG,24,4,0,30,10,19,0.526,1,8,0.125,9,11,0.818,0.553,1,3,0.333,1,8,9,4,0,1,3,1,22
DeMar DeRozan,SF,34,73,73,2745,582,1224,0.475,68,207,0.329,514,1017,0.505,0.503,481,562,0.856,41,275,316,383,80,44,114,149,1713
Mamadi Diakite,PF,27,5,0,24,4,6,0.667,0,1,0,4,5,0.8,0.667,4,6,0.667,1,3,4,2,1,1,1,2,12
Gradey Dick,SG,20,53,12,1058,151,358,0.422,71,197,0.36,80,161,0.497,0.521,38,44,0.864,24,82,106,67,30,2,43,77,411
Ousmane Dieng,PF,20,31,0,342,43,104,0.413,20,67,0.299,23,37,0.622,0.51,14,16,0.875,10,40,50,33,5,3,17,20,120
Spencer Dinwiddie,PG,30,69,51,1992,235,606,0.388,112,342,0.327,123,264,0.466,0.48,154,195,0.79,29,160,189,343,47,19,86,128,736
Spencer Dinwiddie,PG,30,48,48,1474,195,499,0.391,89,278,0.32,106,221,0.48,0.48,125,160,0.781,26,132,158,288,38,9,62,86,604
Spencer Dinwiddie,PG,30,21,3,518,40,107,0.374,23,64,0.359,17,43,0.395,0.481,29,35,0.829,3,28,31,55,9,10,24,42,132
Donte DiVincenzo,SG,27,73,55,2041,386,881,0.438,249,625,0.398,137,256,0.535,0.579,73,100,0.73,58,201,259,190,96,32,96,152,1094
Luka Don?i?,PG,24,65,65,2432,751,1536,0.489,257,676,0.38,494,860,0.574,0.573,451,577,0.782,53,540,593,636,97,34,258,134,2210
Luguentz Dort,SF,24,72,72,2049,257,588,0.437,141,356,0.396,116,232,0.5,0.557,107,129,0.829,70,191,261,100,64,43,65,215,762
Ayo Dosunmu,SG,24,73,34,2102,339,679,0.499,112,280,0.4,227,399,0.569,0.582,81,99,0.818,49,153,202,232,63,34,93,157,871
Jeff Dowtin,PG,26,7,0,86,11,20,0.55,7,14,0.5,4,6,0.667,0.725,2,2,1,2,9,11,17,4,1,5,1,31
Andre Drummond,C,30,75,10,1278,250,454,0.551,0,3,0,250,451,0.554,0.551,122,206,0.592,247,415,662,37,67,47,77,132,622
Chris Duarte,SF,26,54,11,690,78,201,0.388,43,120,0.358,35,81,0.432,0.495,26,33,0.788,25,76,101,42,27,8,23,75,225
Kris Dunn,PG,29,64,32,1202,143,305,0.469,41,109,0.376,102,196,0.52,0.536,18,27,0.667,48,136,184,248,65,28,78,130,345
Kevin Durant,PF,35,67,67,2485,679,1281,0.53,150,353,0.425,529,928,0.57,0.589,339,397,0.854,36,416,452,347,60,88,224,117,1847
Jalen Duren,C,20,56,55,1662,326,518,0.629,0,3,0,326,515,0.633,0.629,126,162,0.778,185,487,672,140,29,47,119,182,778
Tari Eason,PF,22,22,0,480,88,189,0.466,18,50,0.36,70,139,0.504,0.513,21,33,0.636,46,107,153,27,31,19,20,51,215
Anthony Edwards,SG,22,71,70,2502,655,1414,0.463,172,474,0.363,483,940,0.514,0.524,372,450,0.827,46,349,395,366,90,41,222,128,1854
Kessler Edwards,SF,23,48,0,245,31,73,0.425,18,46,0.391,13,27,0.481,0.548,4,8,0.5,9,30,39,11,8,4,3,22,84
Keon Ellis,SG,24,49,13,773,79,173,0.457,50,126,0.397,29,47,0.617,0.601,18,26,0.692,23,72,95,69,41,24,26,85,226
Joel Embiid,C,29,34,34,1157,402,754,0.533,41,112,0.366,361,642,0.562,0.56,356,403,0.883,89,295,384,193,39,60,126,98,1201
Drew Eubanks,C,26,68,5,1069,144,231,0.623,3,3,1,141,228,0.618,0.63,67,87,0.77,93,197,290,58,25,58,59,103,358
Tosan Evbuomwan,SF,22,14,5,276,26,56,0.464,9,26,0.346,17,30,0.567,0.545,13,20,0.65,14,33,47,10,3,2,7,20,74
Tosan Evbuomwan,SF,22,10,5,202,22,41,0.537,7,18,0.389,15,23,0.652,0.622,13,20,0.65,6,27,33,4,3,1,6,15,64
Dante Exum,PG,28,48,15,926,148,268,0.552,48,93,0.516,100,175,0.571,0.642,51,66,0.773,21,100,121,135,21,5,40,75,395
Bruno Fernando,C,25,37,1,516,85,144,0.59,0,4,0,85,140,0.607,0.59,43,66,0.652,54,106,160,32,23,26,35,78,213
Dorian Finney-Smith,PF,30,65,53,1852,208,495,0.42,115,327,0.352,93,168,0.554,0.536,32,44,0.727,106,198,304,103,55,37,53,143,563
Malachi Flynn,PG,25,61,0,718,98,239,0.41,45,131,0.344,53,108,0.491,0.504,36,48,0.75,20,79,99,101,28,7,48,55,277
Malachi Flynn,PG,25,31,0,474,56,137,0.409,28,80,0.35,28,57,0.491,0.511,17,22,0.773,13,52,65,73,18,6,33,42,157
Malachi Flynn,PG,25,14,0,60,9,23,0.391,4,13,0.308,5,10,0.5,0.478,9,11,0.818,0,6,6,6,1,0,3,3,31
Malachi Flynn,PG,25,16,0,184,33,79,0.418,13,38,0.342,20,41,0.488,0.5,10,15,0.667,7,21,28,22,9,1,12,10,89
Simone Fontecchio,SF,28,66,43,1644,252,548,0.46,134,334,0.401,118,214,0.551,0.582,54,66,0.818,64,182,246,101,44,23,68,110,692
Simone Fontecchio,SF,28,50,34,1160,161,358,0.45,91,233,0.391,70,125,0.56,0.577,32,40,0.8,52,124,176,73,30,18,51,81,445
Simone Fontecchio,SF,28,16,9,484,91,190,0.479,43,101,0.426,48,89,0.539,0.592,22,26,0.846,12,58,70,28,14,5,17,29,247
Jordan Ford,PG,25,6,0,22,4,7,0.571,2,3,0.667,2,4,0.5,0.714,2,2,1,0,2,2,2,0,0,1,0,12
Trent Forrest,SG,25,36,0,388,31,85,0.365,2,10,0.2,29,75,0.387,0.376,13,16,0.813,10,36,46,85,10,3,18,25,77
Evan Fournier,SG,31,25,0,435,59,168,0.351,28,104,0.269,31,64,0.484,0.435,24,29,0.828,4,41,45,36,25,3,18,39,170
Evan Fournier,SG,31,3,0,39,4,20,0.2,2,15,0.133,2,5,0.4,0.25,2,2,1,0,4,4,3,4,0,1,4,12
Evan Fournier,SG,31,22,0,396,55,148,0.372,26,89,0.292,29,59,0.492,0.459,22,27,0.815,4,37,41,33,21,3,17,35,158
De'Aaron Fox,PG,26,66,66,2358,637,1370,0.465,182,501,0.363,455,869,0.524,0.531,288,393,0.733,64,237,301,376,133,28,177,174,1744
Javon Freeman-Liberty,PG,24,14,4,236,30,71,0.423,4,24,0.167,26,47,0.553,0.451,20,22,0.909,8,32,40,22,5,2,12,17,84
Alex Fudge,SF,20,4,0,14,1,6,0.167,0,2,0,1,4,0.25,0.167,2,2,1,2,0,2,0,0,0,1,1,4
Markelle Fultz,PG,25,35,16,753,124,266,0.466,3,14,0.214,121,252,0.48,0.472,17,27,0.63,45,68,113,104,36,12,40,52,268
Wenyen Gabriel,PF,26,5,0,81,8,22,0.364,1,6,0.167,7,16,0.438,0.386,0,5,0,7,18,25,3,2,2,8,10,17
Danilo Gallinari,PF-SF,35,45,0,592,79,180,0.439,29,90,0.322,50,90,0.556,0.519,77,90,0.856,18,82,100,52,12,6,18,45,264
Danilo Gallinari,PF,35,26,0,385,57,131,0.435,20,64,0.313,37,67,0.552,0.511,47,56,0.839,12,64,76,31,6,3,12,26,181
Danilo Gallinari,SF,35,6,0,90,12,22,0.545,7,12,0.583,5,10,0.5,0.705,21,24,0.875,2,12,14,12,2,2,1,9,52
Danilo Gallinari,SF,35,13,0,117,10,27,0.37,2,14,0.143,8,13,0.615,0.407,9,10,0.9,4,6,10,9,4,1,5,10,31
Darius Garland,PG,24,51,51,1695,334,747,0.447,115,317,0.363,219,430,0.509,0.524,136,163,0.834,27,106,133,334,62,5,158,87,919
Luka Garza,C,25,20,0,99,25,57,0.439,9,29,0.31,16,28,0.571,0.518,13,18,0.722,13,11,24,3,2,1,5,19,72
Keyonte George,PG,20,68,37,1822,283,728,0.389,131,392,0.334,152,336,0.452,0.479,172,203,0.847,14,180,194,307,34,7,162,82,869
Paul George,PF,33,68,68,2323,542,1150,0.471,229,555,0.413,313,595,0.526,0.571,226,251,0.9,34,325,359,243,105,34,136,189,1539
Taj Gibson,PF,38,17,1,176,8,25,0.32,1,8,0.125,7,17,0.412,0.34,2,2,1,10,20,30,9,3,6,5,29,19
Taj Gibson,PF,38,16,1,165,7,23,0.304,0,6,0,7,17,0.412,0.304,2,2,1,10,18,28,9,2,6,5,28,16
Josh Giddey,SG,21,73,73,1814,366,769,0.476,78,226,0.345,288,543,0.53,0.527,83,104,0.798,102,357,459,338,47,41,144,98,893
Harry Giles,C,25,22,0,98,23,50,0.46,3,14,0.214,20,36,0.556,0.49,7,13,0.538,12,16,28,6,2,3,6,15,56
Harry Giles,C,25,16,0,81,22,44,0.5,3,11,0.273,19,33,0.576,0.534,7,13,0.538,12,14,26,6,1,3,6,15,54
Shai Gilgeous-Alexander,PG,25,71,71,2444,763,1416,0.539,92,252,0.365,671,1164,0.576,0.571,532,610,0.872,62,332,394,447,148,64,156,179,2150
Anthony Gill,PF,31,44,0,307,50,104,0.481,8,28,0.286,42,76,0.553,0.519,24,31,0.774,28,38,66,23,9,7,20,31,132
Collin Gillespie,PG,24,24,0,225,32,69,0.464,15,38,0.395,17,31,0.548,0.572,8,12,0.667,1,20,21,27,13,0,14,24,87
Jacob Gilyard,PG,25,39,14,669,60,146,0.411,51,122,0.418,9,24,0.375,0.586,2,2,1,8,35,43,133,28,5,29,37,173
Jacob Gilyard,PG,25,37,14,654,60,144,0.417,51,120,0.425,9,24,0.375,0.594,2,2,1,8,35,43,131,27,5,29,35,173
Rudy Gobert,C,31,68,68,2318,360,548,0.657,0,3,0,360,545,0.661,0.657,218,343,0.636,252,622,874,88,42,144,104,213,938
Jordan Goodwin,PG,25,50,7,833,108,291,0.371,35,117,0.299,73,174,0.42,0.431,30,41,0.732,58,116,174,122,39,18,48,61,281
Jordan Goodwin,PG,25,40,0,558,75,193,0.389,23,80,0.288,52,113,0.46,0.448,25,29,0.862,40,77,117,78,23,9,29,43,198
Jordan Goodwin,PG,25,10,7,275,33,98,0.337,12,37,0.324,21,61,0.344,0.398,5,12,0.417,18,39,57,44,16,9,19,18,83
Aaron Gordon,PF,28,68,68,2145,372,675,0.551,37,128,0.289,335,547,0.612,0.579,158,242,0.653,164,280,444,230,52,41,101,132,939
Eric Gordon,SG,35,61,24,1743,260,576,0.451,142,366,0.388,118,210,0.562,0.575,48,60,0.8,16,103,119,131,56,28,69,75,710
Devonte' Graham,PG,28,16,0,142,18,45,0.4,12,34,0.353,6,11,0.545,0.533,7,9,0.778,2,19,21,23,5,1,6,7,55
Jerami Grant,PF,29,54,54,1830,383,850,0.451,111,276,0.402,272,574,0.474,0.516,255,312,0.817,37,154,191,152,45,34,116,117,1132
A.J. Green,SG,24,50,0,509,73,171,0.427,60,147,0.408,13,24,0.542,0.602,15,16,0.938,8,48,56,27,6,3,8,44,221
Draymond Green,PF,33,49,46,1307,169,341,0.496,45,116,0.388,124,225,0.551,0.562,52,69,0.754,67,287,354,294,45,41,118,147,435
Jalen Green,SG,21,74,74,2346,515,1207,0.427,181,536,0.338,334,671,0.498,0.502,262,328,0.799,37,343,380,256,60,26,165,101,1473
Jeff Green,PF,37,70,5,1162,145,314,0.462,43,128,0.336,102,186,0.548,0.53,109,134,0.813,39,116,155,58,12,30,44,93,442
Josh Green,SG,23,54,32,1436,175,355,0.493,71,177,0.401,104,178,0.584,0.593,37,55,0.673,38,136,174,125,45,9,57,105,458
AJ Griffin,SF,20,18,0,132,13,45,0.289,9,33,0.273,4,12,0.333,0.389,2,2,1,2,12,14,4,1,1,6,6,37
Quentin Grimes,SG,23,51,18,1025,122,328,0.372,81,240,0.338,41,88,0.466,0.495,34,45,0.756,15,85,100,66,35,7,28,75,359
Quentin Grimes,SG,23,45,18,910,113,286,0.395,77,212,0.363,36,74,0.486,0.53,24,34,0.706,14,74,88,52,30,3,21,66,327
Quentin Grimes,SG,23,6,0,115,9,42,0.214,4,28,0.143,5,14,0.357,0.262,10,11,0.909,1,11,12,14,5,4,7,9,32
Mouhamadou Gueye,PF,25,8,0,64,6,20,0.3,0,1,0,6,19,0.316,0.3,2,6,0.333,8,3,11,2,1,9,6,6,14
Rui Hachimura,PF,25,61,32,1615,317,592,0.535,85,202,0.421,232,390,0.595,0.607,89,121,0.736,48,201,249,68,36,21,41,93,808
Ashton Hagans,PG,24,16,1,276,27,63,0.429,7,20,0.35,20,43,0.465,0.484,12,15,0.8,11,29,40,47,9,9,28,36,73
Tyrese Haliburton,PG,23,62,61,1999,454,954,0.476,175,479,0.365,279,475,0.587,0.568,174,203,0.857,34,211,245,682,73,41,145,66,1257
R.J. Hampton,PG,22,8,2,76,4,14,0.286,1,8,0.125,3,6,0.5,0.321,1,2,0.5,2,4,6,8,0,0,3,8,10
Tim Hardaway Jr.,SF,31,71,10,1949,368,909,0.405,200,553,0.362,168,356,0.472,0.515,139,163,0.853,21,215,236,123,38,6,63,97,1075
James Harden,PG,34,67,67,2331,334,767,0.435,177,453,0.391,157,314,0.5,0.551,282,321,0.879,32,311,343,573,75,57,171,123,1127
Jaden Hardy,SG,21,65,6,882,177,431,0.411,76,207,0.367,101,224,0.451,0.499,49,64,0.766,16,93,109,99,18,4,50,69,479
Gary Harris,SG,29,47,20,1080,118,259,0.456,66,176,0.375,52,83,0.627,0.583,32,43,0.744,21,55,76,72,40,13,27,78,334
Joe Harris,SG,32,16,0,170,14,39,0.359,10,30,0.333,4,9,0.444,0.487,1,2,0.5,3,10,13,10,3,2,4,19,39
Tobias Harris,PF,31,66,66,2237,439,899,0.488,82,240,0.342,357,659,0.542,0.534,176,200,0.88,72,349,421,204,67,41,90,109,1136
Josh Hart,SF,28,73,34,2410,253,605,0.418,75,246,0.305,178,359,0.496,0.48,79,102,0.775,117,487,604,289,65,22,105,148,660
Isaiah Hartenstein,C,25,68,42,1698,206,325,0.634,1,3,0.333,205,322,0.637,0.635,100,137,0.73,223,348,571,158,74,76,79,192,513
Sam Hauser,SF,26,71,10,1516,211,460,0.459,172,397,0.433,39,63,0.619,0.646,15,17,0.882,39,203,242,67,34,23,30,89,609
Jordan Hawkins,SG,21,63,10,1125,171,447,0.383,106,291,0.364,65,156,0.417,0.501,67,80,0.838,28,116,144,70,18,6,38,71,515
Jaxson Hayes,C,23,63,4,759,106,150,0.707,0,8,0,106,142,0.746,0.707,45,72,0.625,59,121,180,28,27,24,35,108,257
Killian Hayes,PG,22,42,31,1008,117,283,0.413,22,74,0.297,95,209,0.455,0.452,33,50,0.66,11,108,119,205,36,20,51,75,289
Gordon Hayward,SF,33,45,26,1127,169,373,0.453,34,83,0.41,135,290,0.466,0.499,80,107,0.748,36,130,166,150,35,12,60,63,452
Gordon Hayward,SF,33,25,25,798,139,297,0.468,22,61,0.361,117,236,0.496,0.505,62,81,0.765,25,92,117,116,28,12,51,46,362
Gordon Hayward,SF,33,20,1,329,30,76,0.395,12,22,0.545,18,54,0.333,0.474,18,26,0.692,11,38,49,34,7,0,9,17,90
Scoot Henderson,PG,19,55,25,1513,257,677,0.38,67,220,0.305,190,457,0.416,0.429,151,184,0.821,46,124,170,268,40,12,175,171,732
Taylor Hendricks,PF,20,33,16,686,84,194,0.433,40,116,0.345,44,78,0.564,0.536,20,25,0.8,39,116,155,21,19,26,22,69,228
Tyler Herro,SG,24,36,36,1209,283,648,0.437,117,293,0.399,166,355,0.468,0.527,66,79,0.835,18,173,191,158,29,3,77,51,749
Buddy Hield,SF-SG,31,77,42,2021,349,787,0.443,204,527,0.387,145,260,0.558,0.573,42,48,0.875,53,193,246,227,64,41,95,158,944
Buddy Hield,SF,31,52,28,1336,229,517,0.443,137,357,0.384,92,160,0.575,0.575,28,33,0.848,34,133,167,139,43,31,62,103,623
Buddy Hield,SG,31,25,14,685,120,270,0.444,67,170,0.394,53,100,0.53,0.569,14,15,0.933,19,60,79,88,21,10,33,55,321
Haywood Highsmith,PF,27,58,26,1153,128,282,0.454,67,166,0.404,61,116,0.526,0.573,23,33,0.697,48,115,163,58,46,26,29,101,346
Nate Hinton,SG,24,11,0,58,10,20,0.5,7,11,0.636,3,9,0.333,0.675,4,5,0.8,3,9,12,6,2,2,2,10,31
D'Moi Hodge,SG,25,7,0,41,5,15,0.333,3,12,0.25,2,3,0.667,0.433,1,2,0.5,0,0,0,5,1,1,1,4,14
Aaron Holiday,PG,27,71,1,1168,170,382,0.445,78,199,0.392,92,183,0.503,0.547,54,59,0.915,21,96,117,131,39,6,49,110,472
Jrue Holiday,PG,33,63,63,2089,307,633,0.485,131,293,0.447,176,340,0.518,0.588,60,72,0.833,77,267,344,312,59,49,115,102,805
Justin Holiday,SG,34,51,9,746,76,166,0.458,46,115,0.4,30,51,0.588,0.596,3,4,0.75,8,54,62,55,31,7,11,63,201
Richaun Holmes,C-PF,30,40,10,555,82,147,0.558,1,3,0.333,81,144,0.563,0.561,34,47,0.723,71,111,182,25,11,19,24,74,199
Richaun Holmes,PF,30,17,8,318,49,88,0.557,1,3,0.333,48,85,0.565,0.563,22,26,0.846,38,66,104,10,8,10,12,41,121
Chet Holmgren,C,21,74,74,2212,460,863,0.533,118,316,0.373,342,547,0.625,0.601,192,241,0.797,115,468,583,188,47,176,118,178,1230
Jalen Hood-Schifino,SG,20,21,0,109,10,45,0.222,2,15,0.133,8,30,0.267,0.244,12,20,0.6,2,11,13,8,3,2,9,13,34
Al Horford,C,37,60,30,1634,193,382,0.505,99,236,0.419,94,146,0.644,0.635,25,28,0.893,76,314,390,158,36,58,44,90,510
Talen Horton-Tucker,PG,23,46,11,880,154,396,0.389,50,155,0.323,104,241,0.432,0.452,77,96,0.802,20,88,108,165,41,16,57,80,435
Danuel House Jr.,SF,30,34,4,509,47,105,0.448,15,50,0.3,32,55,0.582,0.519,35,46,0.761,16,42,58,28,15,5,19,45,144
Caleb Houstan,SF,21,56,12,791,79,200,0.395,71,187,0.38,8,13,0.615,0.573,19,24,0.792,28,54,82,28,13,3,16,61,248
Jett Howard,SF,20,14,0,52,8,23,0.348,5,18,0.278,3,5,0.6,0.457,2,4,0.5,1,4,5,3,0,1,2,3,23
Kevin Huerter,SG,25,64,59,1562,248,560,0.443,123,341,0.361,125,219,0.571,0.553,36,47,0.766,38,186,224,166,45,23,53,135,655
Jay Huff,C,25,17,0,44,7,13,0.538,3,9,0.333,4,4,1,0.654,2,2,1,1,9,10,2,1,1,1,8,19
De'Andre Hunter,SF,26,50,30,1449,267,571,0.468,104,257,0.405,163,314,0.519,0.559,144,168,0.857,29,161,190,69,36,15,67,127,782
Matthew Hurt,PF,23,8,0,113,12,34,0.353,5,20,0.25,7,14,0.5,0.426,3,3,1,9,7,16,4,3,3,2,8,32
Bones Hyland,PG,23,32,4,435,69,189,0.365,33,104,0.317,36,85,0.424,0.452,14,18,0.778,4,30,34,71,20,3,39,42,185
Joe Ingles,SF,36,60,0,1033,89,207,0.43,62,145,0.428,27,62,0.435,0.58,25,29,0.862,18,106,124,179,38,4,56,82,265
Brandon Ingram,SF,26,63,63,2079,494,1008,0.49,85,239,0.356,409,769,0.532,0.532,246,307,0.801,43,276,319,363,50,40,161,145,1319
Kyrie Irving,SG,31,52,52,1795,502,1017,0.494,154,375,0.411,348,642,0.542,0.569,159,176,0.903,39,219,258,274,64,22,88,99,1317
Jonathan Isaac,PF,26,51,1,783,131,251,0.522,38,96,0.396,93,155,0.6,0.598,54,75,0.72,64,159,223,24,37,62,24,55,354
Jaden Ivey,SG,21,69,53,1976,368,853,0.431,103,319,0.323,265,534,0.496,0.492,210,276,0.761,82,160,242,256,52,40,170,193,1049
Andre Jackson Jr.,SG,22,50,8,514,47,89,0.528,15,40,0.375,32,49,0.653,0.612,8,11,0.727,41,60,101,48,14,4,24,83,117
GG Jackson II,PF,19,40,10,962,179,417,0.429,80,219,0.365,99,198,0.5,0.525,95,126,0.754,44,108,152,41,19,20,52,51,533
Isaiah Jackson,C,22,55,3,706,146,219,0.667,0,4,0,146,215,0.679,0.667,69,98,0.704,84,139,223,47,34,53,38,130,361
Jaren Jackson Jr.,C,24,64,64,2053,489,1113,0.439,113,356,0.317,376,757,0.497,0.49,320,397,0.806,83,272,355,147,74,103,157,231,1411
Reggie Jackson,PG,33,75,21,1658,300,684,0.439,93,256,0.363,207,428,0.484,0.507,71,89,0.798,29,112,141,287,41,11,96,134,764
Trayce Jackson-Davis,PF,23,60,8,945,198,281,0.705,0,1,0,198,280,0.707,0.705,61,111,0.55,116,169,285,69,25,63,38,99,457
LeBron James,PF,39,65,65,2289,618,1159,0.533,143,344,0.416,475,815,0.583,0.595,273,363,0.752,54,421,475,526,76,36,219,74,1652
Jaime Jaquez Jr.,SF,22,67,20,1944,316,648,0.488,58,185,0.314,258,463,0.557,0.532,128,159,0.805,76,184,260,174,70,15,102,152,818
DeJon Jarreau,SG,26,9,0,150,17,50,0.34,4,13,0.308,13,37,0.351,0.38,5,11,0.455,8,36,44,26,6,2,9,14,43
DaQuan Jeffries,SG,26,16,0,45,6,17,0.353,2,10,0.2,4,7,0.571,0.412,0,2,0,0,5,5,5,0,1,3,2,14
Isaiah Joe,SG,24,70,0,1287,199,435,0.457,133,317,0.42,66,118,0.559,0.61,38,44,0.864,26,131,157,81,38,18,41,80,569
Cameron Johnson,PF,27,56,47,1550,270,603,0.448,136,345,0.394,134,258,0.519,0.561,82,105,0.781,54,191,245,135,47,15,55,100,758
Jalen Johnson,SF,22,51,48,1733,328,639,0.513,65,184,0.353,263,455,0.578,0.564,100,138,0.725,67,373,440,180,58,46,88,128,821
James Johnson,PF,36,8,0,40,3,9,0.333,0,2,0,3,7,0.429,0.333,2,2,1,1,3,4,7,5,1,4,7,8
Keldon Johnson,SF,24,68,26,2015,389,854,0.456,126,362,0.348,263,492,0.535,0.529,173,219,0.79,94,279,373,194,50,19,97,146,1077
Keon Johnson,SG,21,4,0,51,7,19,0.368,4,9,0.444,3,10,0.3,0.474,10,10,1,3,2,5,3,3,1,4,4,28
Nikola Joki?,C,28,72,72,2486,740,1278,0.579,72,208,0.346,668,1070,0.624,0.607,330,401,0.823,204,679,883,650,93,64,210,176,1882
Colby Jones,SG,21,23,0,144,20,54,0.37,1,15,0.067,19,39,0.487,0.38,2,5,0.4,13,16,29,14,4,1,6,19,43
Damian Jones,C,28,34,0,249,39,65,0.6,2,12,0.167,37,53,0.698,0.615,18,21,0.857,18,41,59,14,7,12,13,26,98
Derrick Jones Jr.,SF,26,69,59,1611,219,446,0.491,75,215,0.349,144,231,0.623,0.575,87,122,0.713,73,158,231,67,49,42,59,107,600
Herbert Jones,SF,25,68,68,2038,267,529,0.505,104,246,0.423,163,283,0.576,0.603,122,142,0.859,70,173,243,176,91,61,81,200,760
Mason Jones,SG,25,3,0,20,2,6,0.333,2,5,0.4,0,1,0,0.5,1,2,0.5,1,4,5,5,1,0,1,1,7
Tre Jones,PG,24,70,41,1901,264,516,0.512,57,163,0.35,207,353,0.586,0.567,99,113,0.876,50,192,242,427,68,7,103,84,684
Tyus Jones,PG,27,66,66,1933,326,666,0.489,106,256,0.414,220,410,0.537,0.569,32,40,0.8,20,159,179,485,71,18,66,48,790
Cory Joseph,PG,32,26,0,296,23,64,0.359,13,42,0.31,10,22,0.455,0.461,4,7,0.571,6,24,30,42,4,3,12,25,63
Nikola Jovi?,PF,20,38,30,706,92,210,0.438,49,120,0.408,43,90,0.478,0.555,23,37,0.622,23,132,155,74,21,13,35,68,256
Johnny Juzang,SG,22,14,1,209,28,66,0.424,16,50,0.32,12,16,0.75,0.545,1,1,1,5,17,22,11,0,0,6,17,73
Luke Kennard,SG,27,37,20,936,133,297,0.448,101,225,0.449,32,72,0.444,0.618,40,45,0.889,11,96,107,124,19,2,49,39,407
Walker Kessler,C,22,63,21,1484,226,347,0.651,4,19,0.211,222,328,0.677,0.657,56,93,0.602,165,316,481,59,30,153,66,131,512
Braxton Key,SF,26,19,0,59,7,17,0.412,2,5,0.4,5,12,0.417,0.471,4,6,0.667,3,13,16,9,2,1,1,5,20
Corey Kispert,SF,24,73,15,1805,338,701,0.482,160,425,0.376,178,276,0.645,0.596,101,140,0.721,26,170,196,126,37,14,85,127,937
Maxi Kleber,C,32,37,7,752,53,126,0.421,26,80,0.325,27,46,0.587,0.524,23,35,0.657,22,97,119,57,14,21,24,70,155
Kevin Knox,SF,24,31,11,560,86,186,0.462,31,94,0.33,55,92,0.598,0.546,20,22,0.909,18,57,75,23,13,7,22,50,223
John Konchar,SF,27,55,23,1173,88,208,0.423,38,120,0.317,50,88,0.568,0.514,21,25,0.84,72,185,257,110,51,51,46,76,235
Furkan Korkmaz,SG,26,35,0,300,30,76,0.395,14,40,0.35,16,36,0.444,0.487,14,20,0.7,4,26,30,25,14,3,10,17,88
Vit Krejci,PG,23,14,12,362,31,64,0.484,16,41,0.39,15,23,0.652,0.609,4,5,0.8,6,22,28,31,8,6,11,34,82
Jonathan Kuminga,PF,21,70,44,1843,438,828,0.529,50,158,0.316,388,670,0.579,0.559,214,289,0.74,88,245,333,148,51,34,116,159,1140
Kyle Kuzma,PF,28,69,69,2243,601,1297,0.463,149,445,0.335,452,852,0.531,0.521,185,239,0.774,62,390,452,293,36,48,188,153,1536
Jock Landale,C,28,48,1,583,76,157,0.484,7,29,0.241,69,128,0.539,0.506,38,47,0.809,75,71,146,47,13,28,22,60,197
Jake LaRavia,PF,22,29,2,597,81,221,0.367,34,113,0.301,47,108,0.435,0.443,61,78,0.782,44,58,102,41,23,8,27,55,257
Zach LaVine,SG,28,25,23,872,170,376,0.452,59,169,0.349,111,207,0.536,0.531,88,103,0.854,8,121,129,98,21,8,52,57,487
A.J. Lawson,SG,23,36,0,254,47,98,0.48,13,42,0.31,34,56,0.607,0.546,13,21,0.619,12,24,36,14,10,3,10,20,120
Saben Lee,PG,24,21,0,178,18,53,0.34,2,16,0.125,16,37,0.432,0.358,29,39,0.744,9,22,31,30,7,3,8,13,67
Alex Len,C,30,40,0,369,45,73,0.616,0,3,0,45,70,0.643,0.616,18,30,0.6,41,69,110,37,10,27,22,52,108
Kawhi Leonard,SF,32,68,68,2330,610,1162,0.525,140,336,0.417,470,826,0.569,0.585,253,286,0.885,84,332,416,244,111,59,119,97,1613
Caris LeVert,SG,29,62,8,1781,306,748,0.409,97,308,0.315,209,440,0.475,0.474,133,177,0.751,35,216,251,329,68,32,105,110,842
Kira Lewis Jr.,PG,22,25,0,204,25,72,0.347,4,27,0.148,21,45,0.467,0.375,15,17,0.882,8,14,22,30,6,2,12,10,69
Kira Lewis Jr.,PG,22,15,0,144,16,52,0.308,2,20,0.1,14,32,0.438,0.327,10,11,0.909,4,10,14,18,5,1,8,8,44
Kira Lewis Jr.,PG,22,9,0,58,9,20,0.45,2,7,0.286,7,13,0.538,0.5,5,6,0.833,4,4,8,12,1,1,4,1,25
E.J. Liddell,PF,23,8,0,23,1,6,0.167,0,5,0,1,1,1,0.167,2,2,1,0,5,5,1,2,2,2,2,4
Damian Lillard,PG,33,68,68,2402,510,1198,0.426,210,586,0.358,300,612,0.49,0.513,429,465,0.923,34,264,298,480,68,15,173,124,1659
Nassir Little,SF,23,40,2,446,54,116,0.466,21,66,0.318,33,50,0.66,0.556,17,20,0.85,14,59,73,21,10,10,13,38,146
Dereck Lively II,C,19,55,42,1294,221,296,0.747,0,2,0,221,294,0.752,0.747,41,81,0.506,135,243,378,60,36,77,50,144,483
Isaiah Livers,PF,25,23,6,469,40,116,0.345,22,77,0.286,18,39,0.462,0.44,12,18,0.667,15,33,48,25,13,5,16,43,114
Chris Livingston,SF,20,17,0,72,8,18,0.444,1,4,0.25,7,14,0.5,0.472,2,2,1,2,13,15,5,2,0,4,11,19
Kenneth Lofton Jr.,PF,21,17,0,108,15,43,0.349,3,12,0.25,12,31,0.387,0.384,8,15,0.533,2,16,18,14,3,3,8,15,41
Kenneth Lofton Jr.,PF,21,15,0,99,14,37,0.378,3,10,0.3,11,27,0.407,0.419,8,15,0.533,2,13,15,14,3,3,6,15,39
Kevon Looney,C,27,67,36,1108,128,211,0.607,0,1,0,128,210,0.61,0.607,51,75,0.68,130,256,386,127,24,23,46,145,307
Brook Lopez,C,35,71,71,2188,324,670,0.484,130,359,0.362,194,311,0.624,0.581,99,119,0.832,101,272,373,118,41,173,68,175,877
Robin Lopez,C,35,16,2,65,7,19,0.368,2,8,0.25,5,11,0.455,0.421,2,2,1,3,2,5,4,1,3,2,7,18
Kevin Love,PF,35,47,5,822,135,305,0.443,74,212,0.349,61,93,0.656,0.564,81,104,0.779,50,242,292,105,16,9,38,85,425
Kyle Lowry,PG,37,55,50,1560,154,360,0.428,92,238,0.387,62,122,0.508,0.556,60,71,0.845,33,146,179,233,57,20,79,133,460
Kyle Lowry,PG,37,37,35,1037,103,242,0.426,62,161,0.385,41,81,0.506,0.554,35,42,0.833,25,104,129,147,39,15,53,94,303
Kyle Lowry,PG,37,18,15,523,51,118,0.432,30,77,0.39,21,41,0.512,0.559,25,29,0.862,8,42,50,86,18,5,26,39,157
Seth Lundy,SF,23,9,0,52,4,17,0.235,3,13,0.231,1,4,0.25,0.324,3,4,0.75,1,6,7,0,0,0,1,6,14
Trey Lyles,PF,28,50,0,987,121,270,0.448,72,185,0.389,49,85,0.576,0.581,46,65,0.708,50,170,220,58,13,15,33,79,360
Th└o Maledon,PG,22,17,1,213,20,70,0.286,5,30,0.167,15,40,0.375,0.321,14,15,0.933,4,20,24,28,7,0,18,21,59
Th└o Maledon,PG,22,13,1,200,19,66,0.288,5,30,0.167,14,36,0.389,0.326,11,12,0.917,4,19,23,28,7,0,15,18,54
Sandro Mamukelashvili,C,24,39,0,268,43,89,0.483,9,38,0.237,34,51,0.667,0.534,14,19,0.737,30,49,79,34,6,9,10,25,109
Terance Mann,SG,27,67,63,1697,214,438,0.489,66,192,0.344,148,246,0.602,0.564,69,83,0.831,77,145,222,110,37,15,40,126,563
Tre Mann,PG,22,33,20,735,110,239,0.46,36,96,0.375,74,143,0.517,0.536,29,39,0.744,17,101,118,121,32,1,48,38,285
Tre Mann,PG,22,13,0,119,20,40,0.5,8,19,0.421,12,21,0.571,0.6,1,1,1,4,20,24,20,3,0,9,3,49
Tre Mann,PG,22,20,20,616,90,199,0.452,28,77,0.364,62,122,0.508,0.523,28,38,0.737,13,81,94,101,29,1,39,35,236
Boban Marjanovi?,C,35,12,0,55,11,24,0.458,0,2,0,11,22,0.5,0.458,6,9,0.667,6,17,23,4,0,1,2,5,28
Lauri Markkanen,PF,26,55,55,1820,427,890,0.48,175,439,0.399,252,451,0.559,0.578,249,277,0.899,122,327,449,110,50,26,77,100,1278
Naji Marshall,SF,26,62,1,1198,164,356,0.461,57,148,0.385,107,208,0.514,0.541,65,82,0.793,52,180,232,122,46,12,62,85,450
Caleb Martin,SF,28,56,19,1518,213,487,0.437,72,199,0.362,141,288,0.49,0.511,70,89,0.787,67,190,257,119,42,22,65,111,568
Cody Martin,SF,28,28,22,753,82,215,0.381,27,86,0.314,55,129,0.426,0.444,20,33,0.606,19,90,109,104,32,18,44,48,211
KJ Martin,SF,23,56,2,667,85,161,0.528,8,28,0.286,77,133,0.579,0.553,22,41,0.537,34,85,119,46,21,9,28,96,200
KJ Martin,SF,23,2,0,31,4,10,0.4,1,5,0.2,3,5,0.6,0.45,1,2,0.5,1,2,3,1,2,1,2,3,10
KJ Martin,SF,23,54,2,636,81,151,0.536,7,23,0.304,74,128,0.578,0.56,21,39,0.538,33,83,116,45,19,8,26,93,190
Garrison Mathews,SG,27,58,4,825,79,173,0.457,67,149,0.45,12,24,0.5,0.65,30,37,0.811,14,65,79,32,15,7,17,104,255
Bennedict Mathurin,SF,21,59,19,1538,296,663,0.446,80,214,0.374,216,449,0.481,0.507,184,224,0.821,60,174,234,119,35,14,97,117,856
Wesley Matthews,SG,37,33,3,396,33,93,0.355,24,66,0.364,9,27,0.333,0.484,16,22,0.727,9,43,52,22,15,11,8,41,106
Tyrese Maxey,PG,23,65,65,2436,582,1307,0.445,196,524,0.374,386,783,0.493,0.52,306,354,0.864,33,205,238,404,65,31,111,139,1666
Skylar Mays,PG-SG,26,35,5,427,63,158,0.399,16,54,0.296,47,104,0.452,0.449,13,17,0.765,10,33,43,84,20,4,20,26,155
Skylar Mays,PG,26,21,5,356,53,138,0.384,14,49,0.286,39,89,0.438,0.435,13,17,0.765,9,28,37,75,14,3,18,20,133
Miles McBride,PG,23,61,12,1127,176,388,0.454,94,225,0.418,82,163,0.503,0.575,37,43,0.86,26,55,81,97,46,6,25,95,483
CJ McCollum,PG,32,58,58,1851,403,886,0.455,195,471,0.414,208,415,0.501,0.565,95,118,0.805,29,214,243,261,56,37,90,114,1096
T.J. McConnell,PG,31,64,4,1151,280,510,0.549,14,37,0.378,266,473,0.562,0.563,47,60,0.783,33,138,171,340,67,7,99,64,621
Jaden McDaniels,SF,23,64,63,1879,279,568,0.491,80,231,0.346,199,337,0.591,0.562,51,72,0.708,53,149,202,88,56,36,78,200,689
Jalen McDaniels,SF,26,43,0,424,53,150,0.353,11,65,0.169,42,85,0.494,0.39,18,26,0.692,13,51,64,26,17,5,25,41,135
Doug McDermott,SF,32,58,0,832,112,259,0.432,86,209,0.411,26,50,0.52,0.598,11,19,0.579,9,47,56,67,14,2,28,59,321
Doug McDermott,SF,32,46,0,700,95,215,0.442,76,173,0.439,19,42,0.452,0.619,10,17,0.588,8,40,48,57,11,2,24,48,276
Doug McDermott,SF,32,12,0,132,17,44,0.386,10,36,0.278,7,8,0.875,0.5,1,2,0.5,1,7,8,10,3,0,4,11,45
JaVale McGee,C,36,43,0,326,75,124,0.605,1,5,0.2,74,119,0.622,0.609,25,43,0.581,39,78,117,15,13,20,32,45,176
Bryce McGowens,SG,21,53,13,800,89,198,0.449,30,91,0.33,59,107,0.551,0.525,54,71,0.761,16,77,93,46,20,7,26,72,262
Jordan McLaughlin,PG,27,48,0,506,57,120,0.475,37,74,0.5,20,46,0.435,0.629,8,12,0.667,15,49,64,88,30,7,15,26,159
De'Anthony Melton,SG,25,36,33,1002,136,348,0.391,75,207,0.362,61,141,0.433,0.499,66,79,0.835,27,110,137,110,56,16,39,82,413
Sam Merrill,SG,27,57,1,1014,152,373,0.408,137,336,0.408,15,37,0.405,0.591,24,26,0.923,21,93,114,101,18,4,18,69,465
Chimezie Metu,C,26,43,7,604,83,170,0.488,16,65,0.246,67,105,0.638,0.535,49,55,0.891,29,108,137,32,27,13,36,57,231
Chimezie Metu,C,26,37,5,448,66,130,0.508,15,51,0.294,51,79,0.646,0.565,38,43,0.884,24,86,110,19,19,9,27,39,185
Chimezie Metu,C,26,6,2,156,17,40,0.425,1,14,0.071,16,26,0.615,0.438,11,12,0.917,5,22,27,13,8,4,9,18,46
Vasilije Mici?,PG,30,53,14,999,138,314,0.439,35,126,0.278,103,188,0.548,0.495,51,64,0.797,14,60,74,218,27,6,83,58,362
Vasilije Mici?,PG,30,30,0,361,37,91,0.407,11,45,0.244,26,46,0.565,0.467,14,19,0.737,1,23,24,76,9,3,29,22,99
Vasilije Mici?,PG,30,23,14,638,101,223,0.453,24,81,0.296,77,142,0.542,0.507,37,45,0.822,13,37,50,142,18,3,54,36,263
Khris Middleton,SF,32,49,49,1322,279,571,0.489,84,222,0.378,195,349,0.559,0.562,89,106,0.84,33,190,223,258,43,15,106,127,731
Brandon Miller,SF,21,67,61,2156,427,982,0.435,164,442,0.371,263,540,0.487,0.518,119,147,0.81,57,231,288,160,58,37,117,169,1137
Jordan Miller,SF,24,8,0,28,5,9,0.556,1,2,0.5,4,7,0.571,0.611,2,2,1,3,2,5,0,0,0,1,2,13
Dariq Whitehead,SF,19,2,0,24,1,5,0.2,0,3,0,1,2,0.5,0.2,1,2,0.5,0,4,4,3,0,1,0,0,3
Patty Mills,PG,35,30,5,396,44,124,0.355,23,81,0.284,21,43,0.488,0.448,9,9,1,9,25,34,33,20,1,16,30,120
Patty Mills,PG,35,11,5,194,25,73,0.342,10,47,0.213,15,26,0.577,0.411,9,9,1,4,10,14,19,11,0,8,13,69
Shake Milton,SG,27,47,0,581,79,195,0.405,18,64,0.281,61,131,0.466,0.451,40,49,0.816,14,61,75,60,19,6,31,54,216
Shake Milton,SG,27,38,0,491,64,160,0.4,14,53,0.264,50,107,0.467,0.444,36,44,0.818,7,44,51,50,16,5,28,44,178
Shake Milton,SG,27,4,0,63,11,26,0.423,3,9,0.333,8,17,0.471,0.481,2,3,0.667,7,11,18,6,2,1,3,3,27
Shake Milton,SG,27,5,0,27,4,9,0.444,1,2,0.5,3,7,0.429,0.5,2,2,1,0,6,6,4,1,0,0,7,11
Justin Minaya,SF,24,28,0,216,12,41,0.293,6,26,0.231,6,15,0.4,0.366,4,8,0.5,14,18,32,9,6,7,7,16,34
Josh Minott,SF,21,26,0,70,12,27,0.444,2,8,0.25,10,19,0.526,0.481,12,14,0.857,3,10,13,4,4,4,2,7,38
Davion Mitchell,PG,25,64,4,908,117,253,0.462,43,124,0.347,74,129,0.574,0.547,24,33,0.727,14,61,75,109,16,3,37,76,301
Donovan Mitchell,SG,27,51,51,1795,470,1015,0.463,169,458,0.369,301,557,0.54,0.546,258,298,0.866,43,221,264,311,89,25,144,111,1367
Evan Mobley,PF,22,43,43,1319,278,472,0.589,17,45,0.378,261,427,0.611,0.607,105,149,0.705,97,323,420,135,37,63,78,120,678
Malik Monk,SG,25,72,0,1872,396,893,0.443,148,423,0.35,248,470,0.528,0.526,170,205,0.829,28,184,212,370,45,39,150,156,1110
Moses Moody,SG,21,58,8,1000,172,370,0.465,61,176,0.347,111,194,0.572,0.547,64,80,0.8,60,115,175,47,38,23,40,75,469
Xavier Moon,SG,29,9,0,37,5,14,0.357,0,5,0,5,9,0.556,0.357,1,2,0.5,2,3,5,7,1,1,4,4,11
Ja Morant,PG,24,9,9,318,80,170,0.471,14,51,0.275,66,119,0.555,0.512,52,64,0.813,6,44,50,73,7,5,27,19,226
Marcus Morris,PF,34,44,7,757,108,246,0.439,45,111,0.405,63,135,0.467,0.53,35,42,0.833,21,108,129,33,14,12,27,68,296
Marcus Morris,PF,34,37,7,637,90,205,0.439,36,90,0.4,54,115,0.47,0.527,31,36,0.861,18,91,109,26,13,11,19,61,247
Marcus Morris,PF,34,7,0,120,18,41,0.439,9,21,0.429,9,20,0.45,0.549,4,6,0.667,3,17,20,7,1,1,8,7,49
Markieff Morris,PF,34,22,1,173,20,54,0.37,13,34,0.382,7,20,0.35,0.491,3,4,0.75,4,27,31,12,5,1,10,11,56
Monte Morris,PG,28,25,0,366,48,121,0.397,18,52,0.346,30,69,0.435,0.471,12,17,0.706,6,33,39,54,16,4,6,9,126
Monte Morris,PG,28,6,0,68,12,33,0.364,2,11,0.182,10,22,0.455,0.394,1,2,0.5,2,10,12,8,1,1,2,1,27
Monte Morris,PG,28,19,0,298,36,88,0.409,16,41,0.39,20,47,0.426,0.5,11,15,0.733,4,23,27,46,15,3,4,8,99
Trey Murphy III,SF,23,49,16,1391,226,523,0.432,139,374,0.372,87,149,0.584,0.565,94,119,0.79,33,198,231,101,40,27,27,58,685
Dejounte Murray,SG,27,71,71,2533,615,1329,0.463,183,502,0.365,432,827,0.522,0.532,196,244,0.803,52,324,376,449,103,23,175,121,1609
Jamal Murray,PG,26,54,54,1733,428,902,0.475,127,303,0.419,301,599,0.503,0.545,147,172,0.855,38,184,222,360,52,33,114,99,1130
Keegan Murray,SF,23,69,69,2296,393,849,0.463,157,435,0.361,236,414,0.57,0.555,94,115,0.817,89,280,369,115,71,51,58,189,1037
Kris Murray,SF,23,54,21,1065,115,285,0.404,38,141,0.27,77,144,0.535,0.47,25,41,0.61,57,113,170,71,46,16,44,69,293
Mike Muscala,C,32,46,6,544,52,146,0.356,28,93,0.301,24,53,0.453,0.452,17,24,0.708,34,78,112,34,9,12,19,47,149
Mike Muscala,C,32,24,2,338,33,90,0.367,14,51,0.275,19,39,0.487,0.444,15,20,0.75,22,53,75,22,5,7,16,31,95
Mike Muscala,C,32,13,4,171,15,44,0.341,13,34,0.382,2,10,0.2,0.489,2,4,0.5,10,19,29,10,3,5,2,13,45
Svi Mykhailiuk,SF,26,33,0,294,36,97,0.371,28,80,0.35,8,17,0.471,0.515,4,7,0.571,8,28,36,22,10,0,9,13,104
Larry Nance Jr.,C,31,55,0,1082,123,209,0.589,24,57,0.421,99,152,0.651,0.646,39,53,0.736,81,197,278,92,54,18,41,83,309
Andrew Nembhard,PG,24,61,40,1507,239,478,0.5,55,152,0.362,184,326,0.564,0.558,37,47,0.787,33,93,126,249,57,5,92,126,570
Aaron Nesmith,SF,24,65,40,1797,284,578,0.491,133,309,0.43,151,269,0.561,0.606,92,122,0.754,56,188,244,99,61,47,59,217,793
Georges Niang,PF,30,75,10,1697,265,585,0.453,139,364,0.382,126,221,0.57,0.572,48,56,0.857,22,240,262,92,24,17,67,176,717
Daishen Nix,PG,21,12,0,39,8,20,0.4,5,14,0.357,3,6,0.5,0.525,1,4,0.25,0,1,1,2,4,0,2,1,22
Zeke Nnaji,PF,23,53,0,522,61,136,0.449,5,21,0.238,56,115,0.487,0.467,42,59,0.712,58,54,112,30,13,37,27,73,169
Jaylen Nowell,SG,24,9,1,156,22,55,0.4,4,23,0.174,18,32,0.563,0.436,3,3,1,3,11,14,16,3,0,5,13,51
Frank Ntilikina,PG,25,5,0,43,1,9,0.111,1,8,0.125,0,1,0,0.167,2,2,1,1,5,6,4,0,0,1,4,5
Jusuf Nurki?,C,29,69,69,1871,301,584,0.515,21,87,0.241,280,497,0.563,0.533,149,236,0.631,201,548,749,258,66,72,156,229,772
Jordan Nwora,SF,25,45,1,583,116,254,0.457,35,111,0.315,81,143,0.566,0.526,37,43,0.86,20,91,111,50,24,10,39,45,304
Jordan Nwora,SF,25,18,0,183,37,82,0.451,11,36,0.306,26,46,0.565,0.518,9,11,0.818,8,25,33,18,6,1,12,19,94
Jordan Nwora,SF,25,27,1,400,79,172,0.459,24,75,0.32,55,97,0.567,0.529,28,32,0.875,12,66,78,32,18,9,27,26,210
Royce O'Neale,SF,30,71,12,1760,194,487,0.398,142,381,0.373,52,106,0.491,0.544,21,31,0.677,55,284,339,201,51,40,68,159,551
Royce O'Neale,SF,30,49,6,1202,126,325,0.388,97,265,0.366,29,60,0.483,0.537,15,22,0.682,38,183,221,137,32,29,51,120,364
Royce O'Neale,SF,30,22,6,558,68,162,0.42,45,116,0.388,23,46,0.5,0.559,6,9,0.667,17,101,118,64,19,11,17,39,187
Chuma Okeke,SF,25,43,8,421,39,109,0.358,23,80,0.288,16,29,0.552,0.463,4,7,0.571,18,60,78,19,9,7,15,19,105
Josh Okogie,SG,25,56,11,949,84,203,0.414,28,93,0.301,56,110,0.509,0.483,76,102,0.745,73,78,151,64,47,23,35,68,272
Onyeka Okongwu,C,23,55,8,1405,223,365,0.611,23,69,0.333,200,296,0.676,0.642,92,116,0.793,145,231,376,74,26,60,45,162,561
Isaac Okoro,SF,23,65,41,1781,224,461,0.486,80,206,0.388,144,255,0.565,0.573,83,122,0.68,65,130,195,126,55,33,54,136,611
Kelly Olynyk,C,32,72,21,1583,245,446,0.549,55,141,0.39,190,305,0.623,0.611,129,156,0.827,98,266,364,324,68,27,138,210,674
Kelly Olynyk,C,32,50,8,1019,145,258,0.562,36,84,0.429,109,174,0.626,0.632,80,95,0.842,63,191,254,219,37,12,81,132,406
Kelly Olynyk,C,32,22,13,564,100,188,0.532,19,57,0.333,81,131,0.618,0.582,49,61,0.803,35,75,110,105,31,15,57,78,268
Eugene Omoruyi,SF,26,36,0,283,59,120,0.492,6,28,0.214,53,92,0.576,0.517,27,39,0.692,29,42,71,27,22,2,18,53,151
Cedi Osman,SF,28,71,2,1251,180,377,0.477,84,217,0.387,96,160,0.6,0.589,35,52,0.673,25,152,177,118,36,11,47,106,479
Kelly Oubre Jr.,SF,28,61,45,1820,339,776,0.437,87,285,0.305,252,491,0.513,0.493,152,203,0.749,86,211,297,87,70,39,76,178,917
Chris Paul,PG,38,50,15,1316,174,392,0.444,67,177,0.379,107,215,0.498,0.529,41,50,0.82,18,181,199,343,58,3,60,91,456
Cameron Payne,PG,29,71,7,1167,193,439,0.44,94,239,0.393,99,200,0.495,0.547,58,67,0.866,16,82,98,182,33,9,59,112,538
Cameron Payne,PG,29,47,2,702,101,222,0.455,52,131,0.397,49,91,0.538,0.572,37,44,0.841,5,57,62,109,22,3,31,73,291
Cameron Payne,PG,29,24,5,465,92,217,0.424,42,108,0.389,50,109,0.459,0.521,21,23,0.913,11,25,36,73,11,6,28,39,247
Gary Payton II,SG,31,39,0,596,85,157,0.541,16,46,0.348,69,111,0.622,0.592,11,18,0.611,43,60,103,44,36,15,23,63,197
M?ozinha Pereira,SF,23,5,0,55,7,16,0.438,1,5,0.2,6,11,0.545,0.469,3,5,0.6,8,9,17,1,4,3,2,6,18
Julian Phillips,SF,20,40,0,323,32,77,0.416,12,38,0.316,20,39,0.513,0.494,13,19,0.684,12,24,36,13,7,7,10,40,89
Jalen Pickett,SG,24,24,0,116,14,33,0.424,8,23,0.348,6,10,0.6,0.545,3,4,0.75,1,11,12,18,3,0,9,13,39
Scotty Pippen Jr.,PG,23,13,8,305,51,104,0.49,21,41,0.512,30,63,0.476,0.591,27,39,0.692,11,30,41,56,17,7,31,35,150
Mason Plumlee,C,33,39,9,556,75,122,0.615,0,1,0,75,121,0.62,0.615,60,87,0.69,51,143,194,43,11,14,28,54,210
Brandin Podziemski,SG,20,66,27,1759,241,541,0.445,80,217,0.369,161,324,0.497,0.519,47,76,0.618,107,273,380,246,58,13,80,113,609
Aleksej Pokusevski,PF,22,20,0,254,28,71,0.394,8,33,0.242,20,38,0.526,0.451,14,20,0.7,13,38,51,24,12,7,12,14,78
Aleksej Pokusevski,PF,22,10,0,60,4,16,0.25,2,11,0.182,2,5,0.4,0.313,2,4,0.5,2,8,10,5,1,1,3,5,12
Aleksej Pokusevski,PF,22,10,0,194,24,55,0.436,6,22,0.273,18,33,0.545,0.491,12,16,0.75,11,30,41,19,11,6,9,9,66
Jordan Poole,SG,24,73,61,2168,447,1088,0.411,166,516,0.322,281,572,0.491,0.487,178,204,0.873,29,165,194,298,79,25,175,235,1238
Craig Porter Jr.,PG,23,48,5,636,115,226,0.509,12,34,0.353,103,192,0.536,0.535,41,56,0.732,21,85,106,116,20,14,44,39,283
Jontay Porter,PF,24,26,5,360,40,104,0.385,20,60,0.333,20,44,0.455,0.481,15,18,0.833,26,56,82,60,20,20,21,35,115
Michael Porter Jr.,SF,25,74,74,2347,482,980,0.492,204,504,0.405,278,476,0.584,0.596,83,100,0.83,98,418,516,110,39,48,84,134,1251
Otto Porter Jr.,SF,30,15,1,174,14,33,0.424,8,23,0.348,6,10,0.6,0.545,3,3,1,6,23,29,8,5,5,2,19,39
Bobby Portis,PF,28,74,1,1793,405,808,0.501,86,220,0.391,319,588,0.543,0.554,94,120,0.783,121,415,536,86,59,27,78,175,990
Kristaps Porzi??is,C,28,52,52,1552,356,699,0.509,101,277,0.365,255,422,0.604,0.582,239,278,0.86,88,273,361,101,36,97,84,146,1052
Micah Potter,PF,25,12,0,127,12,21,0.571,7,13,0.538,5,8,0.625,0.738,3,3,1,5,22,27,2,1,2,3,5,34
Dwight Powell,C,32,58,8,763,68,99,0.687,1,2,0.5,67,97,0.691,0.692,61,84,0.726,84,104,188,77,23,19,29,105,198
Norman Powell,SG,30,70,1,1824,349,705,0.495,152,349,0.436,197,356,0.553,0.603,132,160,0.825,14,165,179,75,39,22,62,127,982
Taurean Prince,PF,29,71,49,1959,232,526,0.441,130,334,0.389,102,192,0.531,0.565,46,64,0.719,16,189,205,109,52,33,63,139,640
Payton Pritchard,PG,26,74,3,1592,235,524,0.448,128,334,0.383,107,190,0.563,0.571,39,48,0.813,64,172,236,225,32,6,52,93,637
Olivier-Maxence Prosper,PF,21,35,0,263,26,75,0.347,8,34,0.235,18,41,0.439,0.4,23,34,0.676,20,44,64,20,5,3,5,17,83
Trevelin Queen,SG,26,13,0,163,14,38,0.368,3,17,0.176,11,21,0.524,0.408,9,12,0.75,3,16,19,18,7,5,7,15,40
Immanuel Quickley,PG-SG,24,62,32,1793,347,803,0.432,153,386,0.396,194,417,0.465,0.527,170,205,0.829,15,211,226,286,43,9,85,102,1017
Immanuel Quickley,SG,24,30,0,720,152,335,0.454,64,162,0.395,88,173,0.509,0.549,82,94,0.872,5,72,77,74,16,3,31,44,450
Immanuel Quickley,PG,24,32,32,1073,195,468,0.417,89,224,0.397,106,244,0.434,0.512,88,111,0.793,10,139,149,212,27,6,54,58,567
Lester Quinones,SG,23,33,0,369,48,123,0.39,27,77,0.351,21,46,0.457,0.5,18,27,0.667,20,50,70,33,6,2,16,41,141
Jahmi'us Ramsey,SG,22,7,1,121,18,41,0.439,6,22,0.273,12,19,0.632,0.512,5,6,0.833,4,18,22,8,7,0,7,10,47
Julius Randle,PF,29,46,46,1630,395,836,0.472,76,244,0.311,319,592,0.539,0.518,236,302,0.781,99,324,423,229,25,12,159,125,1102
Duop Reath,C,27,60,20,1091,209,439,0.476,80,217,0.369,129,222,0.581,0.567,61,83,0.735,83,134,217,63,29,33,51,150,559
Austin Reaves,SG,25,75,50,2412,420,861,0.488,138,378,0.365,282,483,0.584,0.568,223,258,0.864,51,280,331,423,61,19,161,134,1201
Cam Reddish,SF,24,46,26,961,89,228,0.39,36,108,0.333,53,120,0.442,0.469,41,54,0.759,26,71,97,47,47,14,31,62,255
Paul Reed,C,24,75,23,1445,230,433,0.531,20,54,0.37,210,379,0.554,0.554,59,80,0.738,178,261,439,94,57,77,59,183,539
Naz Reid,C,24,73,8,1750,357,748,0.477,148,364,0.407,209,384,0.544,0.576,96,126,0.762,68,305,373,95,52,64,94,152,958
Jared Rhoden,SG,24,10,0,99,13,25,0.52,4,11,0.364,9,14,0.643,0.6,2,2,1,2,14,16,7,1,4,6,12,32
Nick Richards,C,26,64,51,1702,249,362,0.688,0,1,0,249,361,0.69,0.688,129,176,0.733,168,358,526,51,24,74,69,165,627
Josh Richardson,SG,30,43,6,1103,154,347,0.444,66,190,0.347,88,157,0.561,0.539,51,54,0.944,18,103,121,105,24,14,36,76,425
Duncan Robinson,SF,29,64,32,1824,298,654,0.456,183,454,0.403,115,200,0.575,0.596,78,88,0.886,15,150,165,188,43,16,91,153,857
Jerome Robinson,SG,26,19,0,69,9,29,0.31,2,15,0.133,7,14,0.5,0.345,6,10,0.6,1,4,5,5,0,3,2,5,26
Orlando Robinson,C,23,33,7,300,36,72,0.5,8,15,0.533,28,57,0.491,0.556,19,25,0.76,28,56,84,34,7,8,18,35,99
Jeremiah Robinson-Earl,PF,23,33,1,308,42,86,0.488,12,34,0.353,30,52,0.577,0.558,12,15,0.8,21,48,69,20,10,4,13,23,108
David Roddy,PF,22,62,13,1170,165,408,0.404,48,164,0.293,117,244,0.48,0.463,47,68,0.691,53,156,209,79,27,11,57,70,425
David Roddy,PF,22,48,13,1114,155,386,0.402,47,156,0.301,108,230,0.47,0.462,46,67,0.687,51,149,200,76,25,11,54,68,403
David Roddy,PF,22,14,0,56,10,22,0.455,1,8,0.125,9,14,0.643,0.477,1,1,1,2,7,9,3,2,0,3,2,22
Ryan Rollins,PG,21,10,0,66,13,25,0.52,2,3,0.667,11,22,0.5,0.56,13,17,0.765,2,9,11,11,8,3,7,7,41
Derrick Rose,PG,35,24,7,399,76,165,0.461,15,41,0.366,61,124,0.492,0.506,24,27,0.889,7,38,45,78,8,2,31,21,191
Terry Rozier,SG-PG,29,57,56,1926,419,946,0.443,132,381,0.346,287,565,0.508,0.513,162,187,0.866,34,203,237,330,58,20,99,97,1132
Terry Rozier,SG,29,30,30,1065,252,549,0.459,83,232,0.358,169,317,0.533,0.535,109,129,0.845,17,100,117,198,32,12,65,52,696
Terry Rozier,PG,29,27,26,861,167,397,0.421,49,149,0.329,118,248,0.476,0.482,53,58,0.914,17,103,120,132,26,8,34,45,436
Rayan Rupert,SG,19,31,4,373,37,96,0.385,16,40,0.4,21,56,0.375,0.469,15,19,0.789,16,44,60,39,6,2,20,36,105
D'Angelo Russell,PG,27,69,62,2235,449,978,0.459,201,480,0.419,248,498,0.498,0.562,147,180,0.817,28,185,213,439,63,33,141,146,1246
Matt Ryan,SF,26,24,1,375,49,112,0.438,41,90,0.456,8,22,0.364,0.621,13,14,0.929,6,33,39,17,6,1,18,31,152
Domantas Sabonis,C,27,74,74,2651,580,964,0.602,31,78,0.397,549,886,0.62,0.618,260,367,0.708,257,750,1007,615,65,44,244,226,1451
Luka ?amani?,PF,24,36,3,252,35,95,0.368,10,40,0.25,25,55,0.455,0.421,23,29,0.793,12,57,69,9,2,6,15,25,103
Jermaine Samuels,SF,25,11,0,53,8,11,0.727,0,2,0,8,9,0.889,0.727,2,2,1,2,9,11,2,1,1,0,4,18
Gui Santos,PF,21,20,0,158,22,44,0.5,9,22,0.409,13,22,0.591,0.602,14,15,0.933,15,29,44,11,3,2,7,19,67
Dario ?ari?,C,29,62,9,1080,177,381,0.465,73,194,0.376,104,187,0.556,0.56,76,89,0.854,71,206,277,142,30,9,74,111,503
Olivier Sarr,C,24,14,0,95,11,19,0.579,2,6,0.333,9,13,0.692,0.632,10,15,0.667,10,25,35,2,0,7,3,18,34
Marcus Sasser,PG,23,64,4,1137,181,419,0.432,74,195,0.379,107,224,0.478,0.52,48,55,0.873,8,103,111,204,38,9,72,94,484
Admiral Schofield,PF,26,21,0,79,9,24,0.375,5,15,0.333,4,9,0.444,0.479,0,2,0,2,13,15,6,1,0,4,8,23
Dennis Schr?der,PG,30,75,53,2328,380,868,0.438,133,348,0.382,247,520,0.475,0.514,161,195,0.826,33,181,214,452,61,16,144,151,1054
Dennis Schr?der,PG,30,51,33,1559,247,559,0.442,77,220,0.35,170,339,0.501,0.511,127,149,0.852,22,118,140,313,46,8,83,105,698
Dennis Schr?der,PG,30,24,20,769,133,309,0.43,56,128,0.438,77,181,0.425,0.521,34,46,0.739,11,63,74,139,15,8,61,46,356
Dereon Seabron,SG,23,6,0,55,4,13,0.308,1,2,0.5,3,11,0.273,0.346,5,6,0.833,1,6,7,5,2,1,0,4,14
Alperen Sengun,C,21,63,63,2046,527,982,0.537,33,111,0.297,494,871,0.567,0.553,244,352,0.693,183,406,589,312,76,46,162,211,1331
Brice Sensabaugh,SF,20,25,8,419,56,149,0.376,20,81,0.247,36,68,0.529,0.443,24,28,0.857,11,60,71,41,10,2,38,27,156
Collin Sexton,SG,25,75,48,1995,492,995,0.494,124,312,0.397,368,683,0.539,0.557,304,354,0.859,67,130,197,367,61,17,153,149,1412
Landry Shamet,SG,26,46,5,726,118,274,0.431,53,157,0.338,65,117,0.556,0.527,38,46,0.826,16,46,62,54,25,10,30,76,327
Day'Ron Sharpe,C,22,57,1,863,160,274,0.584,4,13,0.308,156,261,0.598,0.591,75,123,0.61,147,213,360,82,23,41,64,126,399
Shaedon Sharpe,SG,20,32,25,1059,176,434,0.406,60,180,0.333,116,254,0.457,0.475,98,119,0.824,42,118,160,94,28,12,72,88,510
Ben Sheppard,SG,22,50,1,665,76,184,0.413,40,124,0.323,36,60,0.6,0.522,20,23,0.87,10,65,75,43,26,2,10,76,212
Pascal Siakam,PF,29,73,73,2453,621,1161,0.535,79,232,0.341,542,929,0.583,0.569,273,373,0.732,123,393,516,329,60,23,131,170,1594
Pascal Siakam,PF,29,39,39,1354,325,623,0.522,46,145,0.317,279,478,0.584,0.559,169,223,0.758,54,192,246,190,32,10,83,87,865
Pascal Siakam,PF,29,34,34,1099,296,538,0.55,33,87,0.379,263,451,0.583,0.581,104,150,0.693,69,201,270,139,28,13,48,83,729
Anfernee Simons,SG,24,46,46,1582,360,837,0.43,156,405,0.385,204,432,0.472,0.523,163,178,0.916,22,145,167,255,23,5,126,98,1039
Marcus Smart,PG,29,20,20,605,102,237,0.43,42,134,0.313,60,103,0.583,0.519,43,56,0.768,6,47,53,86,41,5,62,53,289
Dennis Smith Jr.,PG,26,56,2,1059,147,338,0.435,32,109,0.294,115,229,0.502,0.482,43,58,0.741,50,114,164,203,68,12,68,121,369
Dru Smith,SG,26,9,0,131,15,33,0.455,7,17,0.412,8,16,0.5,0.561,2,2,1,6,8,14,14,9,3,5,12,39
Ish Smith,PG,35,43,5,741,66,158,0.418,4,8,0.5,62,150,0.413,0.43,3,4,0.75,11,65,76,145,17,4,47,49,139
Jabari Smith Jr.,PF,20,68,68,2152,332,733,0.453,120,328,0.366,212,405,0.523,0.535,138,168,0.821,130,435,565,98,50,52,82,183,922
Jalen Smith,C,23,54,13,942,208,347,0.599,57,131,0.435,151,216,0.699,0.682,64,94,0.681,94,205,299,55,14,34,39,116,537
Nick Smith Jr.,SG,19,46,0,643,96,245,0.392,53,125,0.424,43,120,0.358,0.5,11,13,0.846,17,43,60,52,8,7,35,53,256
Terquavion Smith,PG,21,12,0,69,16,40,0.4,12,31,0.387,4,9,0.444,0.55,2,3,0.667,0,2,2,10,7,0,4,4,46
Jeremy Sochan,PF,20,74,73,2193,340,776,0.438,70,227,0.308,270,549,0.492,0.483,111,144,0.771,137,339,476,249,62,40,140,168,861
Jaden Springer,SG-PG,21,45,1,448,52,136,0.382,8,44,0.182,44,92,0.478,0.412,30,36,0.833,33,36,69,40,27,14,30,60,142
Jaden Springer,SG,21,32,1,377,46,118,0.39,8,37,0.216,38,81,0.469,0.424,28,34,0.824,25,33,58,35,25,11,26,49,128
Jaden Springer,PG,21,13,0,71,6,18,0.333,0,7,0,6,11,0.545,0.333,2,2,1,8,3,11,5,2,3,4,11,14
Lamar Stevens,PF,26,34,2,447,90,193,0.466,11,35,0.314,79,158,0.5,0.495,34,43,0.791,28,73,101,22,16,16,23,38,225
Lamar Stevens,PF,26,19,1,122,21,45,0.467,3,8,0.375,18,37,0.486,0.5,8,11,0.727,12,19,31,8,6,5,9,14,53
Lamar Stevens,PF,26,15,1,325,69,148,0.466,8,27,0.296,61,121,0.504,0.493,26,32,0.813,16,54,70,14,10,11,14,24,172
Isaiah Stewart,PF,22,46,45,1423,186,382,0.487,67,175,0.383,119,207,0.575,0.575,64,85,0.753,74,231,305,73,17,38,66,99,503
Julian Strawther,SF,21,45,0,527,81,217,0.373,40,135,0.296,41,82,0.5,0.465,20,27,0.741,5,50,55,44,17,7,19,52,222
Max Strus,SF,27,63,63,2011,279,665,0.42,152,439,0.346,127,226,0.562,0.534,65,83,0.783,57,234,291,235,58,28,97,160,775
Jalen Suggs,SG,22,67,67,1794,296,640,0.463,140,350,0.4,156,290,0.538,0.572,99,130,0.762,44,163,207,179,97,41,125,183,831
Cole Swider,SF,24,15,0,83,15,36,0.417,10,28,0.357,5,8,0.625,0.556,2,2,1,1,6,7,4,1,1,8,2,42
Jae'Sean Tate,SF,28,64,9,1029,108,229,0.472,23,77,0.299,85,152,0.559,0.522,26,39,0.667,61,136,197,64,42,15,37,136,265
Jayson Tatum,PF,25,69,69,2480,637,1345,0.474,217,572,0.379,420,773,0.543,0.554,390,469,0.832,63,506,569,339,70,40,177,137,1881
Terry Taylor,PF,24,30,0,178,19,37,0.514,2,9,0.222,17,28,0.607,0.541,2,3,0.667,15,20,35,10,4,2,7,17,42
Garrett Temple,SG,37,21,0,150,18,39,0.462,8,20,0.4,10,19,0.526,0.564,9,10,0.9,8,21,29,16,8,1,6,14,53
Dalen Terry,SG,21,52,1,557,51,123,0.415,14,62,0.226,37,61,0.607,0.472,21,34,0.618,24,71,95,69,21,11,26,65,137
Daniel Theis,C,31,55,3,915,137,260,0.527,22,59,0.373,115,201,0.572,0.569,34,46,0.739,77,136,213,58,19,46,37,118,330
Daniel Theis,C,31,54,3,907,136,256,0.531,22,58,0.379,114,198,0.576,0.574,34,46,0.739,77,136,213,58,19,46,37,117,328
Cam Thomas,SG,22,59,44,1831,465,1050,0.443,125,341,0.367,340,709,0.48,0.502,243,286,0.85,25,166,191,175,43,13,109,126,1298
Amen Thompson,SF,21,55,16,1177,205,389,0.527,8,56,0.143,197,333,0.592,0.537,89,131,0.679,122,227,349,131,67,34,78,127,507
Ausar Thompson,SF,21,63,38,1583,232,480,0.483,21,113,0.186,211,367,0.575,0.505,71,119,0.597,129,273,402,120,68,59,84,175,556
Klay Thompson,SF,33,70,56,2075,432,1016,0.425,237,621,0.382,195,395,0.494,0.542,112,122,0.918,32,199,231,157,43,31,105,117,1213
Tristan Thompson,C,32,45,0,532,70,111,0.631,0,1,0,70,110,0.636,0.631,15,50,0.3,71,98,169,51,12,14,29,59,155
JT Thor,PF,21,56,1,660,59,155,0.381,23,70,0.329,36,85,0.424,0.455,7,13,0.538,39,81,120,23,8,21,13,50,148
Matisse Thybulle,SF,26,65,19,1487,126,317,0.397,80,231,0.346,46,86,0.535,0.524,22,29,0.759,30,106,136,90,113,49,40,93,354
Xavier Tillman Sr.,C-PF,25,47,14,890,105,250,0.42,15,70,0.214,90,180,0.5,0.45,22,49,0.449,67,130,197,69,47,40,32,70,247
Xavier Tillman Sr.,C,25,34,13,700,87,213,0.408,12,53,0.226,75,160,0.469,0.437,18,43,0.419,56,101,157,57,42,35,29,60,204
Xavier Tillman Sr.,PF,25,13,1,190,18,37,0.486,3,17,0.176,15,20,0.75,0.527,4,6,0.667,11,29,40,12,5,5,3,10,43
Jacob Toppin,SF,23,9,0,38,5,9,0.556,1,4,0.25,4,5,0.8,0.611,2,2,1,3,4,7,3,0,1,1,3,13
Obi Toppin,PF,25,75,28,1601,294,516,0.57,90,224,0.402,204,292,0.699,0.657,69,91,0.758,76,211,287,110,39,37,62,130,747
Karl-Anthony Towns,PF,28,60,60,1969,472,932,0.506,134,317,0.423,338,615,0.55,0.578,250,286,0.874,91,413,504,179,43,40,169,198,1328
Gary Trent Jr.,SG,25,66,36,1835,325,763,0.426,165,412,0.4,160,351,0.456,0.534,67,87,0.77,23,145,168,105,68,10,41,86,882
P.J. Tucker,PF,38,25,4,389,13,39,0.333,10,29,0.345,3,10,0.3,0.462,3,3,1,23,48,71,12,13,7,8,48,39
P.J. Tucker,PF,38,22,1,323,11,34,0.324,8,24,0.333,3,10,0.3,0.441,3,3,1,22,35,57,12,10,5,6,39,33
Myles Turner,C,27,71,71,1936,436,843,0.517,103,295,0.349,333,548,0.608,0.578,227,293,0.775,108,381,489,92,37,130,101,220,1202
Stanley Umude,SG,24,24,2,307,37,84,0.44,24,53,0.453,13,31,0.419,0.583,29,32,0.906,8,43,51,11,8,7,14,40,127
Jonas Valan?i┗nas,C,31,74,74,1773,367,656,0.559,37,111,0.333,330,545,0.606,0.588,145,182,0.797,177,496,673,154,28,68,98,202,916
Jarred Vanderbilt,PF,24,29,6,581,59,114,0.518,8,27,0.296,51,87,0.586,0.553,24,36,0.667,41,97,138,36,36,5,28,43,150
Fred VanVleet,PG,29,67,67,2452,374,905,0.413,204,531,0.384,170,374,0.455,0.526,170,196,0.867,26,221,247,542,87,57,117,160,1122
Devin Vassell,SG,23,68,62,2248,498,1056,0.472,166,446,0.372,332,610,0.544,0.55,161,201,0.801,27,234,261,277,73,23,108,74,1323
Sasha Vezenkov,PF,28,36,0,450,76,168,0.452,39,101,0.386,37,67,0.552,0.568,10,13,0.769,30,58,88,16,18,7,12,37,201
Gabe Vincent,PG,27,6,0,141,13,36,0.361,2,19,0.105,11,17,0.647,0.389,1,2,0.5,2,4,6,16,7,0,3,14,29
Nikola Vu?evi?,C,33,70,68,2397,540,1121,0.482,83,292,0.284,457,829,0.551,0.519,96,117,0.821,193,549,742,235,47,57,113,176,1259
Dean Wade,PF,27,54,32,1108,96,232,0.414,79,202,0.391,17,30,0.567,0.584,20,26,0.769,37,181,218,43,40,25,20,93,291
Franz Wagner,SF,22,66,66,2155,482,1007,0.479,87,309,0.282,395,698,0.566,0.522,239,282,0.848,64,287,351,253,70,26,130,155,1290
Moritz Wagner,C,26,72,1,1288,297,496,0.599,34,103,0.33,263,393,0.669,0.633,152,190,0.8,108,211,319,91,35,20,89,143,780
Ish Wainright,SF,29,10,0,61,7,24,0.292,7,20,0.35,0,4,0,0.438,2,2,1,3,11,14,1,4,1,2,8,23
Ish Wainright,SF,29,7,0,46,6,18,0.333,6,16,0.375,0,2,0,0.5,2,2,1,0,9,9,0,2,1,1,4,20
Jabari Walker,SF,21,65,16,1466,205,432,0.475,33,118,0.28,172,314,0.548,0.513,108,143,0.755,126,289,415,60,40,21,59,155,551
Jarace Walker,PF,20,30,0,315,40,101,0.396,20,52,0.385,20,49,0.408,0.495,8,9,0.889,11,45,56,37,14,11,15,28,108
Lonnie Walker IV,SG,25,53,0,892,188,438,0.429,97,245,0.396,91,193,0.472,0.54,42,55,0.764,10,96,106,64,29,15,47,67,515
Cason Wallace,SG,20,74,10,1528,197,393,0.501,91,213,0.427,106,180,0.589,0.617,25,33,0.758,47,122,169,102,60,32,38,118,510
T.J. Warren,SF,30,8,0,106,13,34,0.382,2,11,0.182,11,23,0.478,0.412,1,2,0.5,5,12,17,7,3,1,4,11,29
P.J. Washington,PF,25,66,38,1988,314,725,0.433,114,365,0.312,200,360,0.556,0.512,90,131,0.687,79,285,364,127,59,52,85,159,832
P.J. Washington,PF,25,44,17,1286,227,509,0.446,79,244,0.324,148,265,0.558,0.524,67,94,0.713,53,179,232,97,38,32,66,112,600
P.J. Washington,PF,25,22,21,702,87,216,0.403,35,121,0.289,52,95,0.547,0.484,23,37,0.622,26,106,132,30,21,20,19,47,232
Yuta Watanabe,SF,29,34,0,464,41,116,0.353,25,85,0.294,16,31,0.516,0.461,10,17,0.588,11,43,54,15,12,7,19,39,117
Yuta Watanabe,SF,29,29,0,382,35,97,0.361,24,75,0.32,11,22,0.5,0.485,10,15,0.667,11,34,45,10,9,7,16,34,104
Yuta Watanabe,SF,29,5,0,82,6,19,0.316,1,10,0.1,5,9,0.556,0.342,0,2,0,0,9,9,5,3,0,3,5,13
Lindy Waters III,SG,26,31,0,199,28,69,0.406,25,60,0.417,3,9,0.333,0.587,1,1,1,4,26,30,16,2,5,6,19,82
Trendon Watford,PF,23,56,0,670,133,247,0.538,22,55,0.4,111,192,0.578,0.583,59,69,0.855,46,108,154,65,21,16,42,88,347
Peyton Watson,SF,21,73,4,1329,188,407,0.462,43,144,0.299,145,263,0.551,0.515,66,98,0.673,49,173,222,73,39,72,53,127,485
Victor Wembanyama,C,20,66,66,1928,505,1079,0.468,113,350,0.323,392,729,0.538,0.52,274,343,0.799,149,542,691,240,85,226,239,146,1397
Blake Wesley,SG,20,54,1,730,84,174,0.483,8,42,0.19,76,132,0.576,0.506,44,66,0.667,16,60,76,144,26,9,40,78,220
Russell Westbrook,PG,35,62,10,1386,270,599,0.451,37,142,0.261,233,457,0.51,0.482,100,147,0.68,88,220,308,274,68,21,125,106,677
Coby White,PG,23,72,71,2641,491,1102,0.446,200,520,0.385,291,582,0.5,0.536,204,243,0.84,41,297,338,376,48,17,154,170,1386
Derrick White,SG,29,68,68,2223,369,791,0.466,184,459,0.401,185,332,0.557,0.583,132,147,0.898,48,245,293,352,69,84,106,140,1054
Cam Whitmore,SF,19,39,1,700,175,378,0.463,63,175,0.36,112,203,0.552,0.546,60,92,0.652,37,115,152,19,26,11,36,49,473
Aaron Wiggins,SG,25,70,1,1037,172,298,0.577,54,109,0.495,118,189,0.624,0.668,42,55,0.764,55,108,163,66,41,16,48,75,440
Andrew Wiggins,SF,28,65,53,1753,319,707,0.451,79,222,0.356,240,485,0.495,0.507,120,163,0.736,103,192,295,111,38,35,77,135,837
Lindell Wigginton,PG,25,3,0,8,2,5,0.4,0,2,0,2,3,0.667,0.4,2,2,1,0,0,0,0,0,0,1,1,6
Alondes Williams,SG,24,4,0,11,1,4,0.25,0,2,0,1,2,0.5,0.25,1,1,1,0,1,1,0,0,0,1,0,3
Brandon Williams,PG,24,12,0,59,8,22,0.364,2,6,0.333,6,16,0.375,0.409,6,11,0.545,3,4,7,12,1,1,3,2,24
Grant Williams,PF,25,70,37,1928,241,542,0.445,115,315,0.365,126,227,0.555,0.551,94,125,0.752,79,207,286,140,41,37,98,205,691
Grant Williams,PF,25,47,33,1242,131,317,0.413,79,210,0.376,52,107,0.486,0.538,41,55,0.745,46,123,169,81,24,27,53,137,382
Grant Williams,PF,25,23,4,686,110,225,0.489,36,105,0.343,74,120,0.617,0.569,53,70,0.757,33,84,117,59,17,10,45,68,309
Jalen Williams,PF,22,67,67,2124,515,953,0.54,100,232,0.431,415,721,0.576,0.593,178,219,0.813,37,230,267,308,75,43,119,173,1308
Jaylin Williams,C,21,61,0,768,77,191,0.403,46,123,0.374,31,68,0.456,0.524,26,32,0.813,31,173,204,83,24,25,28,87,226
Jeenathan Williams,SG,24,18,0,99,18,36,0.5,1,4,0.25,17,32,0.531,0.514,7,10,0.7,10,6,16,7,3,0,2,10,44
Kenrich Williams,PF,29,61,1,881,108,234,0.462,47,124,0.379,61,110,0.555,0.562,5,12,0.417,56,129,185,77,35,8,20,88,268
Patrick Williams,PF,22,43,30,1174,159,359,0.443,59,148,0.399,100,211,0.474,0.525,52,66,0.788,46,120,166,66,40,33,57,87,429
Vince Williams Jr.,SG,23,52,33,1436,169,379,0.446,79,209,0.378,90,170,0.529,0.55,104,130,0.8,59,231,290,175,47,34,92,135,521
Ziaire Williams,SF,22,51,15,1038,150,378,0.397,58,189,0.307,92,189,0.487,0.474,62,75,0.827,35,145,180,75,36,9,66,85,420
Zion Williamson,PF,23,63,63,1966,561,959,0.585,5,14,0.357,556,945,0.588,0.588,309,444,0.696,112,258,370,315,61,38,172,144,1436
Jalen Wilson,PF,23,36,2,496,57,133,0.429,18,53,0.34,39,80,0.488,0.496,29,32,0.906,37,57,94,37,7,1,14,37,161
James Wiseman,C,22,55,3,887,161,252,0.639,0,2,0,161,250,0.644,0.639,60,85,0.706,92,182,274,45,9,33,57,123,382
Christian Wood,PF,28,50,1,872,123,264,0.466,35,114,0.307,88,150,0.587,0.532,66,94,0.702,39,215,254,49,16,33,50,72,347
Delon Wright,PG,31,44,1,674,65,173,0.376,20,58,0.345,45,115,0.391,0.434,35,43,0.814,17,62,79,108,48,10,12,29,185
Delon Wright,PG,31,33,0,456,48,122,0.393,14,38,0.368,34,84,0.405,0.451,24,29,0.828,13,46,59,82,35,8,11,22,134
Delon Wright,PG,31,11,1,218,17,51,0.333,6,20,0.3,11,31,0.355,0.392,11,14,0.786,4,16,20,26,13,2,1,7,51
Thaddeus Young,PF,35,29,6,407,63,103,0.612,1,6,0.167,62,97,0.639,0.617,5,14,0.357,42,55,97,55,21,5,13,43,132
Thaddeus Young,PF,35,23,6,350,54,87,0.621,1,6,0.167,53,81,0.654,0.626,5,12,0.417,29,46,75,50,18,3,11,38,114
Trae Young,PG,25,51,51,1862,418,982,0.426,169,456,0.371,249,526,0.473,0.512,339,396,0.856,22,118,140,553,70,11,220,106,1344
Omer Yurtseven,C,25,41,6,376,64,118,0.542,5,19,0.263,59,99,0.596,0.564,13,21,0.619,50,94,144,19,5,17,27,45,146
Cody Zeller,C,31,40,0,304,25,60,0.417,1,3,0.333,24,57,0.421,0.425,23,38,0.605,47,62,109,36,9,5,15,42,74
